Young, E. H. (Emily Hilda)	Young, E. H (Emily Hilda)	Young, E. H. (Emily Hilda)
Young, Laura DeHart	Young, Laura DeHart	Young, Laura Dehart
Yonge, Charlotte M. (Charlotte Mary)	Yonge, Charlotte M (Charlotte Mary)	Yonge, Charlotte M	Yonge, Charlotte M. (Charlotte Mary)
Long, William J. (William Joseph)	Long, William J. (William Joseph)	Long, William J
Lodge, James, Mrs	Lodge, James, Mrs	Lodge, James
Lockwood, Frank, Sir	Lockwood, Frank, Sir	Lockwood, Frank
Lovecraft, H. P. (Howard Phillips)	Lovecraft, H. P (Howard Phillips)	Lovecraft, H. P. (Howard Phillips)
Loch, Joice NanKivell	Loch, Joice NanKivell	Loch, Joice Nankivell
Lockhart, J. G. (John Gibson)	Lockhart, J. G	Lockhart, J. G. (John Gibson)
Lowenberg, I., Mrs	Lowenberg, I, Mrs	Lowenberg, I., Mrs
George, W. L. (Walter Lionel)	George, W. L. (Walter Lionel)	George, W. L
Gerry, Margarita (Spalding)	Gerry, Margarita (Spalding)	Gerry, Margarita Spalding
George, John L. (John Lothar)	George, John L. (John Lothar)	George, John L (John Lothar)
Gerson, Noel B. (Noel Bertram)	Gerson, Noel B. (Noel Bertram)	Gerson, Noel B (Noel Bertram)
Tencin, Claudine Alexandrine Guérin de	Tencin, Claudine Alexandrine Guérin de	Tencin, Claudine Alexandrine Guérin de
Temple, Dorothy (Osborne)	Temple, Dorothy Osborne	Temple, Dorothy (Osborne)
Ober, Frederick A. (Frederick Albion)	Ober, Frederick A	Ober, Frederick A. (Frederick Albion)
Obruchev, V. A. (Vladimir Afanasʹevich)	Obruchev, V. A (Vladimir Afanasʹevich)	Obruchev, V. A. (Vladimir Afanasʹevich)
Joyce, P. W. (Patrick Weston)	Joyce, P. W	Joyce, P. W. (Patrick Weston)
Jones, Henry, Sir	Jones, Henry	Jones, Henry, Sir
Joshi, V. K. (Virendra Kumar)	Joshi, V. K. (Virendra Kumar)	Joshi, V. K (Virendra Kumar)
Johnstone, C. I. (Christian Isobel)	Johnstone, C. I	Johnstone, C. I. (Christian Isobel)
Jones, J. B. (John Beauchamp)	Jones, J. B. (John Beauchamp)	Jones, J. B
Johnston, Annie F. (Annie Fellows)	Johnston, Annie F	Johnston, Annie F. (Annie Fellows)	Johnston, Annie F (Annie Fellows)
Jones, T. E. (Theodore Eldon)	Jones, T. E	Jones, T. E. (Theodore Eldon)
Johnson, Charles (Charles Richard)	Johnson, Charles (Charles Richard)	Johnson, Charles Richard
Johnston, J. P. (James Perry)	Johnston, J. P. (James Perry)	Johnston, J. P
Johnston, W. J. (William John)	Johnston, W. J. (William John)	Johnston, W. J
Kelly, M. A. B. (Meriba Ada Babcock)	Kelly, M. A. B. (Meriba Ada Babcock)	Kelly, M. A. B
Kendall, Ralph S. (Ralph Selwood)	Kendall, Ralph S. (Ralph Selwood)	Kendall, Ralph S
Kennedy, Sara Beaumont (Cannon)	Kennedy, Sara Beaumont (Cannon)	Kennedy, Sara Beaumont Cannon
Kennard, Nina H, Mrs	Kennard, Nina H	Kennard, Nina H, Mrs
Keyser, Charles S. (Charles Shearer)	Keyser, Charles S. (Charles Shearer)	Keyser, Charles S (Charles Shearer)
Kennedy, Sidney R. (Sidney Robinson)	Kennedy, Sidney R. (Sidney Robinson)	Kennedy, Sidney R
Ketcham, Wilmot Alexander	Ketcham, Wilmot Alexander	Ketcham,Wilmot Alexander
Keane, John F. (John Fryer)	Keane, John F.(John Fryer)	Keane, John F. (John Fryer)
Synge, J. M. (John Millington)	Synge, J. M	Synge, J. M. (John Millington)
Slosson, Annie (Trumbull), Mrs	Slosson, Annie Trumbull, Mrs	Slosson, Annie (Trumbull), Mrs	Slosson, Annie Trumbull	Slosson, Annie (Trumbull)
Slaughter, Gertrude Elizabeth (Taylor)	Slaughter, Gertrude Elizabeth (Taylor)	Slaughter, Gertrude Elizabeth Taylor
Slaughter, Frank G. (Frank Gill)	Slaughter, Frank G (Frank Gill)	Slaughter, Frank G. (Frank Gill)
Twombly, Alexander S. (Alexander Stevenson)	Twombly, Alexander S. (Alexander Stevenson)	Twombly, Alexander S (Alexander Stevenson)
Wodehouse, P. G., (Pelham Grenville)	Wodehouse, P. G., (Pelham Grenville)	Wodehouse, P. G (Pelham Grenville)	Wodehouse, P. G. (Pelham Grenville)
Woolley, Leonard, Sir	Woolley, Leonard, Sir	Woolley, Leonard
Wood, Edith (Elmer), Mrs	Wood, Edith Elmer	Wood, Edith (Elmer), Mrs
Woodward, R. Pitcher (Robert Pitcher)	Woodward, R. Pitcher (Robert Pitcher)	Woodward, R. Pitcher. [from old catalog]
Woodrow, Wilson, Mrs	Woodrow, Wilson, Mrs	Woodrow, Wilson
Wood, Edward D. (Edward Davis)	Wood, Edward D. (Edward Davis)	Wood, Edward D (Edward Davis)
Wood, J. G. (John George)	Wood, J. G. (John George)	Wood, J. G
Edwards, H. Sutherland (Henry Sutherland)	Edwards, H. Sutherland	Edwards, H. Sutherland (Henry Sutherland)
Sisson, C. H. (Charles Hubert)	Sisson, C. H. (Charles Hubert)	Sisson, C. H (Charles Hubert)
Sims, Mrs. Marian (McCamy)	Sims, Mrs. Marian (McCamy)	Sims, Marian McCamy
Simpson, E. Blantyre (Evelyn Blantyre)	Simpson, E. Blantyre (Evelyn Blantyre)	Simpson, E. Blantyre
Sime, J. G. (Jessie Georgina)	Sime, J. G. (Jessie Georgina)	Sime, J. G (Jessie Georgina)
Sidgwick, Alfred, Mrs	Sidgwick, Alfred	Sidgwick, Alfred, Mrs
Sigourney, L. H. (Lydia Howard)	Sigourney, L. H	Sigourney, L. H. (Lydia Howard)
Sidney, Philip, Sir	Sidney, Philip	Sidney, Philip, Sir
Needell, J. H, Mrs	Needell, J. H, Mrs	Needell, J. H
Newell, C. M. (Charles Martin)	Newell, C. M. (Charles Martin)	Newell, C. M (Charles Martin)
Nemirovich-Danchenko, Vasili?_ Ivanovich	Nemirovich-Danchenko, Vasili?_ Ivanovich	Nemirovich-Danchenko, Vasiliĭ Ivanovich	Nemirovich-Danchenko, Vasiliĩ Ivanovich
Nesbit, E. (Edith)	Nesbit, E (Edith)	Nesbit, E	Nesbit, E. (Edith)
Neely, Henry M. (Henry Milton)	Neely, Henry M	Neely, Henry M. (Henry Milton)
Neverov, A. S. (Aleksandr Sergeevich)	Neverov, A. S (Aleksandr Sergeevich)	Neverov, A. S. (Aleksandr Sergeevich)
Newby, P. H. (Percy Howard)	Newby, P. H (Percy Howard)	Newby, P. H. (Percy Howard)
Newbolt, Henry John, Sir	Newbolt, Henry John	Newbolt, Henry John, Sir
Newell, R. H. (Robert Henry)	Newell, R. H	Newell, R. H. (Robert Henry)
Newton, W. Douglas, (Wilfrid Douglas)	Newton, W. Douglas (Wilfrid Douglas)	Newton, W. Douglas, (Wilfrid Douglas)
Neale, W. Johnson (William Johnson)	Neale, W. Johnson (William Johnson)	Neale, W. Johnson
Neal, Joseph C. (Joseph Clay)	Neal, Joseph C. (Joseph Clay)	Neal, Joseph C
Neale, J. M. (John Mason)	Neale, J. M. (John Mason)	Neale, J. M (John Mason)
Fullerton, Hugh S. (Hugh Stuart)	Fullerton, Hugh S	Fullerton, Hugh S. (Hugh Stuart)
Furmanov, Dm. (Dmitriĭ)	Furmanov, Dm (Dmitriĭ)	Furmanov, Dm. (Dmitriĭ)	Furmanov, Dm. (Dmitriĭ)
Fuller, John G. (John Grant)	Fuller, John G (John Grant)	Fuller, John G. (John Grant)
Fuessle, Newton A. (Newton Augustus)	Fuessle, Newton A	Fuessle, Newton A. (Newton Augustus)
Fullerton, Georgiana Charlotte Seveson-Gower, Lady	Fullerton, Georgiana Charlotte Seveson-Gower, Lady	Fullerton, Georgiana Charlotte Seveson-Gower
Pringle, Elizabeth W. Allston (Elizabeth Waties Allston)	Pringle, Elizabeth W. Allston (Elizabeth Waties Allston)	Pringle, Elizabeth W. Allston
Prentiss, E. (Elizabeth)	Prentiss, E	Prentiss, E. (Elizabeth)
Prishvin, Mikhail Mikhaĭlovich	Prishvin, Mikhail Mikhaĭlovich	Prishvin, Mikhail Mikhaĭlovich
Presser, J. (Jacob)	Presser, J. (Jacob)	Presser, J (Jacob)
Pritchett, V. S. (Victor Sawdon)	Pritchett, V. S. (Victor Sawdon)	Pritchett, V. S (Victor Sawdon)
Priestley, J. B. (John Boynton)	Priestley, J. B (John Boynton)	Priestley, J. B. (John Boynton)
Pratz, C. de (Claire)	Pratz, C. de	Pratz, C. de (Claire)
Praed, Campbell, Mrs	Praed, Campbell	Praed, Campbell, Mrs
Prescott, H. F. M. (Hilda Frances Margaret)	Prescott, H. F. M. (Hilda Frances Margaret)	Prescott, H. F. M (Hilda Frances Margaret)
Prince, Helen Choate (Helen Choate Pratt)	Prince, Helen Choate Pratt	Prince, Helen Choate (Helen Choate Pratt)	Prince, Helen Choate (Pratt), Mrs
Prodgers, C. H. (Cecil Herbert)	Prodgers, C. H	Prodgers, C. H (Cecil Herbert)	Prodgers, C. H. (Cecil Herbert)
Yeats, W. B. (William Butler)	Yeats, W. B	Yeats, W. B. (William Butler)	Yeats, W. B (William Butler)
Colman, (Pamela Chandler), Mrs	Colman, (Pamela Chandler), Mrs	Colman, Pamela Chandler
Cobb, James F. (James Francis)	Cobb, James F. (James Francis)	Cobb, James F
Covey, Elizabeth Rockford, Mrs	Covey, Elizabeth (Rockford)	Covey, Elizabeth Rockford, Mrs
Cozzens, Frederic S. (Frederic Swartwout)	Cozzens, Frederic S. (Frederic Swartwout)	Cozzens, Frederic S
Cowles, Julia (Darrow), Mrs	Cowles, Julia (Darrow), Mrs	Cowles, Julia Darrow
Cory, Charles B. (Charles Barney)	Cory, Charles B	Cory, Charles B. (Charles Barney)
Coates, Robert M. (Robert Myron)	Coates, Robert M (Robert Myron)	Coates, Robert M. (Robert Myron)
Cobb, Irvin S. (Irvin Shrewsbury)	Cobb, Irvin S	Cobb, Irvin S. (Irvin Shrewsbury)	Cobb, Irvin S (Irvin Shrewsbury)
Comstock, Harriet T. (Harriet Theresa)	Comstock, Harriet T. (Harriet Theresa)	Comstock, Harriet T
Cox, George W. (George William)	Cox, George W	Cox, George W (George William)	Cox, George W. (George William)
Coppard, A. E. (Alfred Edgar)	Coppard, A. E. (Alfred Edgar)	Coppard, A. E	Coppard, A. E (Alfred Edgar)
Countess of, Munster, Wilhelmina Kennedy-Erskine FitzClarence	Countess of, Munster, Wilhelmina Kennedy-Erskine FitzClarence	Countess of, Munster, Wilhelmina Fitzclarence
Collingwood, Herbert W. (Herbert Winslow)	Collingwood, Herbert W. (Herbert Winslow)	Collingwood, Herbert W
Cody, Louisa (Frederici), Mrs	Cody, Louisa (Frederici)	Cody, Louisa (Frederici), Mrs
Costello, F. H. (Frederick Hankerson)	Costello, F. H. (Frederick Hankerson)	Costello, F. H
Connolly, James B. (James Brendan)	Connolly, James B. (James Brendan)	Connolly, James B	Connolly, James B (James Brendan)
Compton-Burnett, I. (Ivy)	Compton-Burnett, I. (Ivy)	Compton-Burnett, I (Ivy)
Cooper, E. H. (Edward Herbert)	Cooper, E. H. (Edward Herbert)	Cooper, E. H
Coulton, G. G. (George Gordon)	Coulton, G. G. (George Gordon)	Coulton, G. G
Cory, David (David Magie)	Cory, David Magie	Cory, David (David Magie)
Colmore, G. (Gertrude)	Colmore, G	Colmore, G. (Gertrude)
Cottrell, Dorothy Wilkinson, Mrs	Cottrell, Dorothy Wilkinson, Mrs	Cottrell, Dorothy Wilkinson	Cottrell, Dorothy (Wilkinson)
Coursey, O. W. (Oscar William)	Coursey, O. W. (Oscar William)	Coursey, O. W (Oscar William)
Cody, H. A. (Hiram Alfred)	Cody, H. A	Cody, H. A. (Hiram Alfred)
Cooley, Alice (Kingsbury)	Cooley, Alice Kingsbury	Cooley, Alice (Kingsbury)
Codman, Russell, Mrs	Codman, Russell	Codman, Russell, Mrs
Coleridge, Mary E. (Mary Elizabeth)	Coleridge, Mary E. (Mary Elizabeth)	Coleridge, Mary E
Cornford, L. Cope (Leslie Cope)	Cornford, L. Cope (Leslie Cope)	Cornford, L. Cope
Conkling, Margaret C. (Margaret Cockburn)	Conkling, Margaret C	Conkling, Margaret C. (Margaret Cockburn)
Costain, Thomas B. (Thomas Bertram)	Costain, Thomas B. (Thomas Bertram)	Costain, Thomas B (Thomas Bertram)
Cobban, J. Maclaren (James Maclaren)	Cobban, J. Maclaren	Cobban, J. Maclaren (James Maclaren)
Hornung, E. W. (Ernest William)	Hornung, E. W	Hornung, E. W. (Ernest William)
Horne, R. H. (Richard H.)	Horne, R. H. (Richard H.)	Horne, R. H
Hodgetts, J. Frederick (James Frederick)	Hodgetts, J. Frederick (James Frederick)	Hodgetts, J. Frederick
Howe, Sonia E. (Sonia Elizabeth)	Howe, Sonia E. (Sonia Elizabeth)	Howe, Sonia E (Sonia Elizabeth)
Hoffmann, E. T. A. (Ernst Theodor Amadeus)	Hoffmann, E. T. A. (Ernst Theodor Amadeus)	Hoffmann, E. T. A (Ernst Theodor Amadeus)
Howe, E. W. (Edgar Watson)	Howe, E. W. (Edgar Watson)	Howe, E. W
Hobart, George V. (George Vere)	Hobart, George V	Hobart, George V. (George Vere)
Howe, Maud Howe, Mrs	Howe, Maud	Howe, Maud Howe, Mrs
Holland, J. G. (Josiah Gilbert)	Holland, J. G. (Josiah Gilbert)	Holland, J. G
Hoover, Francis T. (Francis Trout)	Hoover, Francis T	Hoover, Francis T. (Francis Trout)
Hotchkiss, Chauncey C. (Chauncey Crafts)	Hotchkiss, Chauncey C. (Chauncey Crafts)	Hotchkiss, Chauncey Crafts
Hoopes, Mary Howard (Peterson), Mrs	Hoopes, Mary Howard (Peterson), Mrs	Hoopes, Mary Howard (Peterson)
Hope, Edward Hope	Hope, Edward	Hope, Edward Hope
Hoyle, Fred, Sir	Hoyle, Fred	Hoyle, Fred, Sir
Holmes, Robert Derby	Holmes, Robert Derby. [from old catalog]	Holmes, Robert Derby
Hobart, Alice Tisdale Nourse, Mrs	Hobart, Alice Tisdale Nourse	Hobart, Alice Tisdale	Hobart, Alice Tisdale Nourse, Mrs
Howard, M. W. (Milford Wriarson)	Howard, M. W	Howard, M. W. (Milford Wriarson)
Hodgetts, E. A. Brayley (Edward Arthur Brayley)	Hodgetts, E. A. Brayley	Hodgetts, E. A. Brayley (Edward Arthur Brayley)
Hough, S. B. (Stanley Bennett)	Hough, S. B (Stanley Bennett)	Hough, S. B. (Stanley Bennett)
Holmes, Richard S. (Richard Sill)	Holmes, Richard S	Holmes, Richard S. (Richard Sill)
Horlock, Knightley William	Horlock, Knightley William	Horlock, Knightley Willia
Howe, W. H. (Walter Henry)	Howe, W. H	Howe, W. H. (Walter Henry)
Isaman, Sara (White)	Isaman, Sara White	Isaman, Sara (White)
Ackerley, J. R. (Joe Randolph)	Ackerley, J. R. (Joe Randolph)	Ackerley, J. R (Joe Randolph)
Seymour, St. John D. (St. John Drelincourt)	Seymour, St. John D	Seymour, St. John D (St. John Drelincourt)	Seymour, St. John D. (St. John Drelincourt)
Service, Robert W. (Robert William)	Service, Robert W. (Robert William)	Service, Robert W (Robert William)
Sedgwick, Susan Anne Livingston (Ridley)	Sedgwick, Susan Anne Livingston (Ridley)	Sedgwick, Susan Anne Livingston Ridley
Seaman, Owen, Sir	Seaman, Owen, Sir	Seaman, Owen
Seymour, Beatrice Kean (Stapleton), Mrs	Seymour, Beatrice Kean	Seymour, Beatrice Kean (Stapleton), Mrs
Downing, Margaret B. (Margaret Brent)	Downing, Margaret B. (Margaret Brent)	Downing, Margaret B (Margaret Brent)
Dorsey, George A. (George Amos)	Dorsey, George A. (George Amos)	Dorsey, George A (George Amos)	Dorsey, George A
Dougall, L. (Lily)	Dougall, L (Lily)	Dougall, L. (Lily)
Donleavy, J. P. (James Patrick)	Donleavy, J. P. (James Patrick)	Donleavy, J. P (James Patrick)
Donovan, Frances R, Mrs	Donovan, Frances R	Donovan, Frances R, Mrs
Douglas, Robert K. (Robert Kennaway), Sir	Douglas, Robert K	Douglas, Robert K. (Robert Kennaway), Sir
Doyle, C. W. (Charles William)	Doyle, C. W	Doyle, C. W. (Charles William)
Dorrance, Ethel Arnold Smith, Mrs	Dorrance, Ethel Arnold Smith	Dorrance, Ethel Arnold Smith, Mrs
Doyle, Arthur Conan, Sir	Doyle, Arthur Conan, Sir	Doyle, Arthur Conan
Douglas, Lloyd C. (Lloyd Cassel)	Douglas, Lloyd C (Lloyd Cassel)	Douglas, Lloyd C. (Lloyd Cassel)
Doty, Madeleine Z. (Madeleine Zabriskie)	Doty, Madeleine Z. (Madeleine Zabriskie)	Doty, Madeleine Z
Oemler, Marie (Conway), Mrs	Oemler, Marie Conway	Oemler, Marie (Conway) Mrs	Oemler, Marie (Conway)	Oemler, Marie Conway, Mrs	Oemler, Marie (Conway), Mrs
Faure, Raoul C. (Raoul Cohen)	Faure, Raoul C (Raoul Cohen)	Faure, Raoul C. (Raoul Cohen)
Fay, Theodore S. (Theodore Sedgwick)	Fay, Theodore S	Fay, Theodore S. (Theodore Sedgwick)
Farrar, F. W. (Frederic William)	Farrar, F. W. (Frederic William)	Farrar, F. W	Farrar, F. W (Frederic William)
Faversham, Julie (Opp)	Faversham, Julie (Opp)	Faversham, Julie Opp
Farjeon, B. L. (Benjamin Leopold)	Farjeon, B. L. (Benjamin Leopold)	Farjeon, B. L
Farrell, James T. (James Thomas)	Farrell, James T (James Thomas)	Farrell, James T. (James Thomas)
Farnham, Eliza W. (Eliza Wood)	Farnham, Eliza W. (Eliza Wood)	Farnham, Eliza W
Farrar, Charles A. J. (Charles Alden John)	Farrar, Charles A. J. (Charles Alden John)	Farrar, Charles A. J
Eydoux-D??mians, M.	Eydoux-D??mians, M. [from old catalog]	Eydoux-D??mians, M
Gilbert, W. S. (William Schwenck)	Gilbert, W. S	Gilbert, W. S. (William Schwenck)
Gibbs, A. Hamilton (Arthur Hamilton)	Gibbs, A. Hamilton	Gibbs, A. Hamilton (Arthur Hamilton)
Gibson, Charles B. (Charles Bernard)	Gibson, Charles B. (Charles Bernard)	Gibson, Charles B
Gilmore, James R. (James Roberts)	Gilmore, James R	Gilmore, James R. (James Roberts)
Gielow, Martha S. (Martha Sawyer)	Gielow, Martha S. (Martha Sawyer)	Gielow, Martha S
Gilman, Caroline (Howard)	Gilman, Caroline Howard	Gilman, Caroline (Howard)
Gillie, R. C. (Robert Calder)	Gillie, R. C. (Robert Calder)	Gillie, R. C
Gilbreth, Frank B. (Frank Bunker)	Gilbreth, Frank B. (Frank Bunker)	Gilbreth, Frank B (Frank Bunker)
Gilliam, E. W. (Edward Winslow)	Gilliam, E. W	Gilliam, E. W. (Edward Winslow)
Gilder, Jeannette L. (Jeannette Leonard)	Gilder, Jeannette L. (Jeannette Leonard)	Gilder, Jeannette L
Oxley, James MacDonald	Oxley, James MacDonald	Oxley, James Macdonald
Oxley, J. Macdonald (James Macdonald)	Oxley, J. Macdonald (James Macdonald)	Oxley, J. Macdonald
Phelps, E. Stuart (Elizabeth Stuart)	Phelps, E. Stuart (Elizabeth Stuart)	Phelps, E. Stuart
Phra Thēpwisutthimēthī (Ngư̄am)	Phra Thēpwisutthimēthī (Ngư̄am)	Phra Thēpwisutthimēthī (Ngūam)
Underwood, Edna (Worthley), Mrs	Underwood, Edna Worthley, Mrs	Underwood, Edna Worthley	Underwood, Edna (Worthley), Mrs
Ognev, N. (Nikolaĭ)	Ognev, N. (Nikolaĭ)	Ognev, N. (Nikolaĭ)	Ognev, N (Nikolaĭ)	Ognev, N (Nikolaĭ)
Bennett, W. H (William Henry)	Bennett, W. H	Bennett, W. H (William Henry)
Bell, J. J. (John Joy)	Bell, J. J. (John Joy)	Bell, J. J
Beerbohm, Max, Sir	Beerbohm, Max, Sir	Beerbohm, Max
Benson, E. F. (Edward Frederick)	Benson, E. F. (Edward Frederick)	Benson, E. F (Edward Frederic)	Benson, E. F	Benson, E. F. (Edward Frederic)	Benson, E.F. (Edward Frederic)
Bezzerides, A. I. (Albert Isaac)	Bezzerides, A. I. (Albert Isaac)	Bezzerides, A. I (Albert Isaac)
Beresford, J. D. (John Davys)	Beresford, J. D	Beresford, J. D. (John Davys)
Bell, F. McKelvey (Frederick McKelvey)	Bell, F. McKelvey	Bell, F. McKelvey (Frederick McKelvey)
Berkeley, Grantley F. (Grantley Fitzhardinge)	Berkeley, Grantley F. (Grantley Fitzhardinge)	Berkeley, Grantley F
Bentley, E. C. (Edmund Clerihew)	Bentley, E. C. (Edmund Clerihew)	Bentley, E. C (Edmund Clerihew)
Berlin, Ellin Mackay	Berlin, Ellin Mackay	Berlin, Ellin MacKay
Belisle, D. W. (David W.)	Belisle, D. W	Belisle, D. W. (David W.)
Bedford-Jones, H. (Henry)	Bedford-Jones, H	Bedford-Jones, H. (Henry)
Beck, L. Adams (Lily Adams)	Beck, L. Adams	Beck, L. Adams (Lily Adams)
Beebe, Iola, Mrs	Beebe, Iola	Beebe, Iola, Mrs
Beecher, Henry Ward, Mrs	Beecher, Henry Ward, Mrs	Beecher, Henry Ward
Bechdolt, Frederick R. (Frederick Ritchie)	Bechdolt, Frederick R. (Frederick Ritchie)	Bechdolt, Frederick R
Besant, Walter, Sir	Besant, Walter, Sir	Besant, Walter
Benson, B. K. (Blackwood Ketcham)	Benson, B. K. (Blackwood Ketcham)	Benson, B. K
Belcher, Edward, Sir	Belcher, Edward, Sir	Belcher, Edward
Benecke, Else C. M. (Else Cecilia Mendelssohn)	Benecke, Else C. M	Benecke, Else C. M. (Else Cecilia Mendelssohn)
Aldrich, Mildred	Aldrich, Mildred. [from old catalog]	Aldrich, Mildred
Alger, Abby L. (Abby Langdon)	Alger, Abby L. (Abby Langdon)	Alger, Abby L
Alden, W. L. (William Livingston)	Alden, W. L	Alden, W. L. (William Livingston)
Alexander, Louis C. (Louis Charles)	Alexander, Louis C	Alexander, Louis C. (Louis Charles)
Allen, William, Mrs	Allen, William	Allen, William, Mrs
Altsheler, Joseph A. (Joseph Alexander)	Altsheler, Joseph A	Altsheler, Joseph A. (Joseph Alexander)
Allinson, Anne Crosby (Emery), Mrs	Allinson, Anne Crosby (Emery), Mrs	Allinson, Anne Crosby Emery
Almqvist, C. J. L. (Carl Jonas Love)	Almqvist, C. J. L. (Carl Jonas Love)	Almqvist, C. J. L (Carl Jonas Love)
Alexander, Mrs	Alexander	Alexander, Mrs
Allee, Marjorie (Hill), Mrs	Allee, Marjorie Hill	Allee, Marjorie (Hill), Mrs
Alvarez, A. (Alfred)	Alvarez, A (Alfred)	Alvarez, A. (Alfred)
Almedingen, E. M. (Edith Martha)	Almedingen, E. M. (Edith Martha)	Almedingen, E. M (Edith Martha)
Novikov-Priboĭ, A. S. (Alekseĭ Silych)	Novikov-Priboĭ, A. S (Alekseĭ Silych)	Novikov-Priboĭ, A. S. (Alekseĭ Silych)
Noel, Augusta (Keppel), Lady	Noel, Augusta (Keppel), Lady	Noel, Lady Augusta (Keppel)
Northrup, A. Judd (Ansel Judd)	Northrup, A. Judd	Northrup, A. Judd (Ansel Judd)
Norris, W. E. (William Edward)	Norris, W. E	Norris, W. E. (William Edward)
Krasnov, P. N. (Petr Nikolaevich)	Krasnov, P. N. (Petr Nikolaevich)	Krasnov, P. N (Petr Nikolaevich)
Krishnamurti, J. (Jiddu)	Krishnamurti, J. (Jiddu)	Krishnamurti, J	Krishnamurti, J (Jiddu)
Lawrence, D. H. (David Herbert)	Lawrence, D. H (David Herbert)	Lawrence, D. H	Lawrence, D. H. (David Herbert)
Lawson, Alfred W. (Alfred William)	Lawson, Alfred W. (Alfred William)	Lawson, Alfred W
Landis, Simon M. (Simon Mohler)	Landis, Simon M	Landis, Simon M. (Simon Mohler)
La Fayette, (Marie-Madeleine Pioche de La Vergne), Madame de	La Fayette, (Marie-Madeleine Pioche de La Vergne), Madame de	La Fayette, Madame de (Marie-Madeleine Pioche de La Vergne)
Lamson, Mary (Swift), Mrs	Lamson, Mary (Swift)	Lamson, Mary (Swift), Mrs	Lamson, Mary Swift
Latta, Robert R. (Robert Ray)	Latta, Robert R. (Robert Ray)	Latta, Robert R (Robert Ray)
Laing, Hamilton M. (Hamilton Mack)	Laing, Hamilton M. (Hamilton Mack)	Laing, Hamilton M
Lawrence, Henry Montgomery, Sir	Lawrence, Henry Montgomery	Lawrence, Henry Montgomery, Sir
Laughlin, Clara E. (Clara Elizabeth)	Laughlin, Clara E. (Clara Elizabeth)	Laughlin, Clara E
Lathrop, George Parsons, 1851-1898	Lathrop, George Parsons	Lathrop, George Parsons, 1851-1898
Lauder, Harry, Sir	Lauder, Harry, Sir	Lauder, Harry
Lawrence, George A. (George Alfred)	Lawrence, George A	Lawrence, George A. (George Alfred)
Laut, Agnes C. (Agnes Christina)	Laut, Agnes C. (Agnes Christina)	Laut, Agnes C
Lauder, Maria Elise Turner, Mrs	Lauder, Maria Elise Turner	Lauder, Maria Elise Turner, Mrs
Boyle, Virginia (Frazer), Mrs	Boyle, Virginia (Frazer), Mrs	Boyle, Virginia Frazer	Boyle, Virginia (Frazer)
Boyns, R. E. (Richard Edward)	Boyns, R. E. (Richard Edward)	Boyns, R. E
Bone, David W. (David William)	Bone, David W	Bone, David W. (David William)
Bower, B. M, Mrs	Bower, B. M	Bower, B. M, Mrs
Borgman, C. F. (Charles F.)	Borgman, C. F. (Charles F.)	Borgman, C. F (Charles F.)
Bolton, Sarah (Knowles)	Bolton, Sarah (Knowles)	Bolton, Sarah Knowles
Booth, Edward C. (Edward Charles)	Booth, Edward C. (Edward Charles)	Booth, Edward C
Bodkin, M. McDonnell (Matthias McDonnell)	Bodkin, M. McDonnell (Matthias McDonnell)	Bodkin, M. McDonnell	Bodkin, M. McD. (Matthias McDonnell)
Botsford, Charles A. (Charles Alexander)	Botsford, Charles A. (Charles Alexander)	Botsford, Charles A
Boston, L. M. (Lucy Maria)	Boston, L. M (Lucy Maria)	Boston, L. M. (Lucy Maria)
Bourhill, E. J, Mrs	Bourhill, E. J	Bourhill, E. J, Mrs
Spofford, Harriet Elizabeth Prescott, Mrs	Spofford, Harriet Elizabeth Prescott	Spofford, Harriet Elizabeth Prescott, Mrs
Speilmann, M. H, Mrs	Speilmann, M. H, Mrs	Speilmann, M. H
Spencer, Bella Zilfa, Mrs	Spencer, Bella Zilfa	Spencer, Bella Zilfa, Mrs
Spearman, Frank H. (Frank Hamilton)	Spearman, Frank H. (Frank Hamilton)	Spearman, Frank H
Spackman, W. M. (William Mode)	Spackman, W. M (William Mode)	Spackman, W. M. (William Mode)
Spivak, John L. (John Louis)	Spivak, John L (John Louis)	Spivak, John L. (John Louis)
Spectorsky, A. C. (Auguste C.)	Spectorsky, A. C. (Auguste C.)	Spectorsky, A. C (Auguste C.)
G. S. Lee,, Lee, Jennette Barbour (Perry), Mrs	G. S. Lee, Lee, Jennette Barbour Perry, Mrs	G. S. Lee, Lee, Jennette Barbour (Perry), Mrs	G. S. Lee,, Lee, Jennette Barbour (Perry), Mrs
Meek, S. P. (Sterner St. Paul)	Meek, S. P	Meek, S. P. (Sterner St. Paul)
Meyer, John J. (John Joseph)	Meyer, John J (John Joseph)	Meyer, John J. (John Joseph)
Merwin, W. S. (William Stanley)	Merwin, W. S (William Stanley)	Merwin, W. S. (William Stanley)
Mencken, H. L. (Henry Louis)	Mencken, H. L. (Henry Louis)	Mencken, H. L
Mehdevi, Anne (Sinclair)	Mehdevi, Anne Sinclair	Mehdevi, Anne (Sinclair)
Mechling, W        H.	Mechling, W        H	Mechling, W. H
Freeman, Lewis R. (Lewis Ransome)	Freeman, Lewis R. (Lewis Ransome)	Freeman, Lewis R
Fraser, Hugh, Mrs	Fraser, Hugh	Fraser, Hugh, Mrs
Freiherr de, La Motte-Fouqué, Friedrich Heinrich Karl	Freiherr de, La Motte-Fouqué, Friedrich Heinrich Karl	Freiherr de, La Motte-Fouqué, Friedrich Heinrich Karl
Friedman, I. K. (Isaac Kahn)	Friedman, I. K	Friedman, I. K. (Isaac Kahn)
French, Harry W. (Harry Willard)	French, Harry W	French, Harry W. (Harry Willard)
Frankland, Edward  Percy	Frankland, Edward Percy	Frankland, Edward  Percy
Frey, Albert R. (Albert Romer)	Frey, Albert R. (Albert Romer)	Frey, Albert R
Frederick, John T. (John Towner)	Frederick, John T. (John Towner)	Frederick, John T (John Towner)
Friel, Arthur O. (Arthur Olney)	Friel, Arthur O	Friel, Arthur O. (Arthur Olney)
Friedman, B. H. (Bernard Harper)	Friedman, B. H. (Bernard Harper)	Friedman, B. H (Bernard Harper)
Freeman, Mary Eleanor (Wilkins), Mrs	Freeman, Mary Eleanor (Wilkins), Mrs	Freeman, Mary Eleanor Wilkins
Perkins, Edna Brush, Mrs	Perkins, Edna Brush, Mrs	Perkins, Edna Brush
Perry, B. F. (Benjamin Franklin)	Perry, B. F. (Benjamin Franklin)	Perry, B. F
Peck, George W. (George Wilbur)	Peck, George W (George Wilbur)	Peck, George W. (George Wilbur)	Peck, George W
Pearce, J. H. (Joseph Henry)	Pearce, J. H	Pearce, J. H. (Joseph Henry)
Pemberton, Max, Sir	Pemberton, Max	Pemberton, Max, Sir
Pepys, Charlotte Maria, Lady	Pepys, Charlotte Maria, Lady	Pepys, Charlotte Maria
Pearson, C. H. (Charles Henry)	Pearson, C. H. (Charles Henry)	Pearson, C. H
Pearson, T. Gilbert (Thomas Gilbert)	Pearson, T. Gilbert (Thomas Gilbert)	Pearson, T. Gilbert
Pedler, Margaret (Bass), Mrs	Pedler, Margaret (Bass)	Pedler, Margaret (Bass), Mrs
Pearson, Paul M. (Paul Martin)	Pearson, Paul M	Pearson, Paul M. (Paul Martin)
Peattie, Louise Redfield, Mrs	Peattie, Louise Redfield, Mrs	Peattie, Louise Redfield
Peterson, Charles J. (Charles Jacobs)	Peterson, Charles J (Charles Jacobs)	Peterson, Charles J. (Charles Jacobs)
Pearson, Emily Clemens	Pearson, Emily Clemens]	Pearson, Emily Clemens
Peirce, B. K. (Bradford Kinney)	Peirce, B. K	Peirce, B. K. (Bradford Kinney)
Pennell, Elizabeth (Robins)	Pennell, Elizabeth Robins	Pennell, Elizabeth (Robins)
Wright, Mary (Tappan), Mrs	Wright, Mary Tappan	Wright, Mary (Tappan), Mrs	Wright, Mary Tappan, Mrs
Wright, J. W. (Jacob William)	Wright, J. W	Wright, J. W. (Jacob William)
Schaeffer, L. M. (Luther Melanchthon)	Schaeffer, L. M. (Luther Melanchthon)	Schaeffer, L. M
Scully, W. C. (William Charles)	Scully, W. C	Scully, W. C. (William Charles)
Schuyler, George S.   (George Samuel)	Schuyler, George S.   (George Samuel)	Schuyler, George S (George Samuel)
Scott, Evelyn, Mrs	Scott, Evelyn, Mrs	Scott, Evelyn
Schaeffer, Evelyn (Schuyler), Mrs	Schaeffer, Evelyn (Schuyler)	Schaeffer, Evelyn (Schuyler), Mrs
Schwarz, Leo W. (Leo Walder)	Schwarz, Leo W (Leo Walder)	Schwarz, Leo W. (Leo Walder)
Scott, J. D. (John Dick)	Scott, J. D (John Dick)	Scott, J. D. (John Dick)
Scott, Walter, Sir	Scott, Walter	Scott, Walter, Sir
Scott-James, R. A. (Rolfe Arnold)	Scott-James, R. A. (Rolfe Arnold)	Scott-James, R. A
Scudder, Horace Elisha	Scudder, Horace Elisha. [from old catalog]	Scudder, Horace Elisha
Judson, Emily C. (Emily Chubbuck)	Judson, Emily C. (Emily Chubbuck)	Judson, Emily C
Art︠s︡ybashev, M. (Mikhail)	Art︠s︡ybashev, M. (Mikhail)	Art︠s︡ybashev, M (Mikhail)
Arnold, Edwin Lester Londen	Arnold, Edwin Lester Londen	Arnold, Edwin Lester Linden
Arthur, T. S. (Timothy Shay)	Arthur, T. S (Timothy Shay)	Arthur, T. S. (Timothy Shay)	Arthur, T. S
Art͡sybashev, M. (Mikhail)	Art͡sybashev, M (Mikhail)	Art͡sybashev, M. (Mikhail)
Avena, M  R    (Mauro Ragasa)	Avena, M  R    (Mauro Ragasa)	Avena, M. R (Mauro R.)
Owen, H. Collinson (Harry Collinson)	Owen, H. Collinson (Harry Collinson)	Owen, H. Collinson
Yaşar, Kemal	Yaşar Kemal	Yaşar, Kemal
Evans, Augusta J. (Augusta Jane)	Evans, Augusta J (Augusta Jane)	Evans, Augusta J	Evans, Augusta J. (Augusta Jane)
Evans, Marguerite Florence H??l??ne Jervis	Evans, Marguerite Florence Jervis	Evans, Marguerite Florence H??l??ne Jervis	Evans, Marguerite Florence Jervis Barclay
Evarts, Hal G. (Hal George)	Evarts, Hal G	Evarts, Hal G. (Hal George)
Evans, Della J.	Evans, Della J. [from old catalog]	Evans, Della J
Evans, Florence (Wilkinson), Mrs	Evans, Florence (Wilkinson)	Evans, Florence (Wilkinson), Mrs	Evans, Florence Wilkinson
Skinner, Ada M. (Ada Maria)	Skinner, Ada M	Skinner, Ada M. (Ada Maria)
Skinner, B. F. (Burrhus Frederic)	Skinner, B. F. (Burrhus Frederic)	Skinner, B. F (Burrhus Frederic)
Skelton, John, Sir	Skelton, John	Skelton, John, Sir
Skinner, Charles M. (Charles Montgomery)	Skinner, Charles M. (Charles Montgomery)	Skinner, Charles M
Bigham, Madge A. (Madge Alford)	Bigham, Madge A	Bigham, Madge A. (Madge Alford)
Bickley, Francis Lawrence	Bickley, Francis Lawrence	Bickley, Francis Lawrance
Binstead, Arthur M. (Arthur Morris)	Binstead, Arthur M	Binstead, Arthur M. (Arthur Morris)
Bicknell, Frank M. (Frank Martin)	Bicknell, Frank M. (Frank Martin)	Bicknell, Frank M
Bigelow, Edith Evelyn (Jaffray)	Bigelow, Edith Evelyn	Bigelow, Edith Evelyn (Jaffray)
Bingham, Mrs. Kate Boyles	Bingham, Mrs. Kate Boyles	Bingham, Kate Boyles
Vulliamy, C. E. (Colwyn Edward)	Vulliamy, C. E (Colwyn Edward)	Vulliamy, C. E. (Colwyn Edward)
Koontz, Dean R. (Dean Ray)	Koontz, Dean R. (Dean Ray)	Koontz, Dean R (Dean Ray)
Kovalevskai͡a, S. V. (Sofʹi͡a Vasilʹevna)	Kovalevskai͡a, S. V (Sofʹi͡a Vasilʹevna)	Kovalevskai͡a, S. V. (Sofʹi͡a Vasilʹevna)
Whitechurch, Victor L. (Victor Lorenzo)	Whitechurch, Victor L	Whitechurch, Victor L. (Victor Lorenzo)
Whyte-Melville, G. J. (George John)	Whyte-Melville, G. J	Whyte-Melville, G. J. (George John)
Whiteing, Richard	Whiteing,Richard	Whiteing, Richard
White, Nelia (Gardner), Mrs	White, Nelia Gardner, Mrs	White, Nelia (Gardner), Mrs	White, Nelia Gardner
Whitaker, R. H. (Robert H.)	Whitaker, R. H	Whitaker, R. H. (Robert H.)
White, T. H. (Terence Hanbury)	White, T. H (Terence Hanbury)	White, T. H. (Terence Hanbury)
White, E. B. (Elwyn Brooks)	White, E. B (Elwyn Brooks)	White, E. B. (Elwyn Brooks)
Wheeler, William Lamont, Mrs	Wheeler, William Lamont, Mrs	Wheeler, William Lamont
Whitney, A. D. T. (Adeline Dutton Train)	Whitney, A. D. T	Whitney, A. D. T. (Adeline Dutton Train)
White, Theodore H. (Theodore Harold)	White, Theodore H. (Theodore Harold)	White, Theodore H (Theodore Harold)
White, Fred M. (Fred Merrick)	White, Fred M	White, Fred M. (Fred Merrick)
Drain, James A.	Drain, James A. [from old catalog]	Drain, James A
Dryer, Bernard V. (Bernard Victor)	Dryer, Bernard V (Bernard Victor)	Dryer, Bernard V. (Bernard Victor)
comtesse de, Genlis, Stéphanie Félicité	comtesse de, Genlis, Stéphanie Félicité	comtesse de, Genlis, Stéphanie Félicité
condesa de, Pardo Bazán, Emilia	condesa de, Pardo Bazán, Emilia	condesa de, Pardo Bazán, Emilia
Eastman, Mary H. (Mary Henderson)	Eastman, Mary H. (Mary Henderson)	Eastman, Mary H (Mary Henderson)	Eastman, Mary H
Eaton, Charlotte, Mrs	Eaton, Charlotte	Eaton, Charlotte, Mrs
Tomlinson, Everett T. (Everett Titsworth)	Tomlinson, Everett T. (Everett Titsworth)	Tomlinson, Everett T	Tomlinson, Everett T.,$1859-1931
Tomlinson, H. M. (Henry Major)	Tomlinson, H. M (Henry Major)	Tomlinson, H. M. (Henry Major)	Tomlinson, H. M
Townsend, Edward W. (Edward Waterman)	Townsend, Edward W. (Edward Waterman)	Townsend, Edward W (Edward Waterman)	Townsend, Edward W
Tolkien, J. R. R. (John Ronald Reuel)	Tolkien, J. R. R (John Ronald Reuel)	Tolkien, J. R. R. (John Ronald Reuel)
Blox, John E.	Blox, John E	Blox, John E.]
Blackford, (Martha), Mrs	Blackford, Martha	Blackford, (Martha), Mrs
Bloundelle-Burton, John Edward	Bloundelle-Burton, John	Bloundelle-Burton, John Edward
Blavatsky, H. P. (Helena Petrovna)	Blavatsky, H. P	Blavatsky, H. P. (Helena Petrovna)
Blessington, Marguerite, Countess of	Blessington, Marguerite, Countess of	Blessington, Marguerite
Blythe, Samuel G. (Samuel George)	Blythe, Samuel G. (Samuel George)	Blythe, Samuel G
Blackmore, R. D. (Richard Dooddridge)	Blackmore, R. D (Richard Doddridge)	Blackmore, R. D. (Richard Doddridge)	Blackmore, R. D. (Richard Dooddridge)	Blackmore, R. D
Bleek, W. H. I. (Wilhelm Heinrich Immanuel)	Bleek, W. H. I (Wilhelm Heinrich Immanuel)	Bleek, W. H. I. (Wilhelm Heinrich Immanuel)
Byron-Curtiss, A. L. (Arthur Lester)	Byron-Curtiss, A. L. (Arthur Lester)	Byron-Curtiss, A. L
Byng, Lucy Margaret (Greenly) Schomberg, Mrs	Byng, Lucy Margaret (Greenly) Schomberg	Byng, Lucy Margaret (Greenly) Schomberg, Mrs
Byatt, A. S. (Antonia Susan)	Byatt, A. S (Antonia Susan)	Byatt, A. S. (Antonia Susan)
Watson, Thomas E. (Thomas Edward)	Watson, Thomas E (Thomas Edward)	Watson, Thomas E. (Thomas Edward)
Watanna, Onoto, Mrs	Watanna, Onoto, Mrs	Watanna, Onoto
Warren, Maude Radford (Maude Lavinia Radford)	Warren, Maude Lavinia Radford	Warren, Maude Radford	Warren, Maude Radford (Maude Lavinia Radford)
Walker, Charles R. (Charles Rumford)	Walker, Charles R	Walker, Charles R (Charles Rumford)	Walker, Charles R. (Charles Rumford)
Walter, Otto F. (Otto Friedrich)	Walter, Otto F (Otto Friedrich)	Walter, Otto F. (Otto Friedrich)
Wadelton, Maggie Jeanne (Melody) Mrs	Wadelton, Maggie Jeanne (Melody) Mrs	Wadelton, Maggie Jeanne (Melody)
Waller, Mary E. (Mary Ella)	Waller, Mary E. (Mary Ella)	Waller, Mary E
Waddington, Mary Alsop King, Mme	Waddington, Mary Alsop King, Mme	Waddington, Mary Alsop (King)
Ward, Catherine G. (Catherine George)	Ward, Catherine G. (Catherine George)	Ward, Catherine G
Waterman, Arba N. (Arba Nelson)	Waterman, Arba N. (Arba Nelson)	Waterman, Arba N
Walton, O. F., Mrs	Walton, O. F, Mrs	Walton, O. F., Mrs
Ward, F. Marshall, Mrs	Ward, F. Marshall	Ward, F. Marshall, Mrs
Ward, R. Plumer (Robert Plumer)	Ward, R. Plumer	Ward, R. Plumer (Robert Plumer)
Warfield, Catherine Ann (Catherine Ann Ware)	Warfield, Catherine Ann Ware	Warfield, Catherine Ann (Catherine Ann)	Warfield, Catherine Ann (Catherine Ann Ware)
Ware, Mary Smith Dabney, Mrs	Ware, Mary Smith Dabney, Mrs	Ware, Mary Smith Dabney
Washburn, Charles A. (Charles Ames)	Washburn, Charles A. (Charles Ames)	Washburn, Charles A
Wade, Horace (Horace Atkisson)	Wade, Horace Atkisson	Wade, Horace (Horace Atkisson)
Walpole, Hugh, Sir	Walpole, Hugh	Walpole, Hugh, Sir
Warfel, Harry R. (Harry Redcay)	Warfel, Harry R (Harry Redcay)	Warfel, Harry R. (Harry Redcay)
Ward, Wilfrid, Mrs	Ward, Wilfrid, Mrs	Ward, Wilfrid
Watson, Augusta (Campbell), Mrs	Watson, Augusta Campbell	Watson, Augusta (Campbell), Mrs
Wynne, Madeline (Yale), Mrs	Wynne, Madeline (Yale)	Wynne, Madeline Yale	Wynne, Madeline (Yale), Mrs
Wyneken, L. Ernest (Leopold Ernest)	Wyneken, L. Ernest	Wyneken, L. Ernest (Leopold Ernest)
Wylie, I. A. R. (Ida Alexa Ross)	Wylie, I. A. R	Wylie, I. A. R. (Ida Alexa Ross)	Wylie, I. A. R (Ida Alexa Ross)
Hill, A. F. (Alonzo F.)	Hill, A. F	Hill, A. F. (Alonzo F.)
Hind, C. Lewis (Charles Lewis)	Hind, C. Lewis	Hind, C. Lewis (Charles Lewis)
Hichens, Robert (Robert Smythe)	Hichens, Robert (Robert Smythe)	Hichens, Robert Smythe
Hill, Marion, Mrs	Hill, Marion	Hill, Marion, Mrs
Hilton, Harold H. (Harold Horsfall)	Hilton, Harold H	Hilton, Harold H. (Harold Horsfall)
Goodwin, C. C. (Charles Carroll)	Goodwin, C. C	Goodwin, C. C. (Charles Carroll)
Goodwin, Maud Wilder, Mrs	Goodwin, Maud Wilder, Mrs	Goodwin, Maud Wilder
Gowen, Herbert H. (Herbert Henry)	Gowen, Herbert H. (Herbert Henry)	Gowen, Herbert H (Herbert Henry)
Gorbatov, Boris Leontʹevich	Gorbatov, Boris Leontʹevich	Gorbatov, Boris Leontevich
Goodrich, Samuel G. (Samuel Griswold)	Goodrich, Samuel G	Goodrich, Samuel G. (Samuel Griswold)
Goodwin, H. B. (Hannah Bradbury)	Goodwin, H. B	Goodwin, H. B. (Hannah Bradbury)
Gore, J. Rogers (John Rogers)	Gore, J. Rogers	Gore, J. Rogers (John Rogers)
Goff, H. N. K. (Harriet Newell Kneeland)	Goff, H. N. K	Goff, H. N. K. (Harriet Newell Kneeland)
Gorgas, Annie Gaskin (Stewart)	Gorgas, Annie Gaskin Stewart	Gorgas, Annie Gaskin (Stewart)
Nazhivin, Iv. (Ivan)	Nazhivin, Iv (Ivan)	Nazhivin, Iv. (Ivan)
Naylor, J. B. (James Ball)	Naylor, J. B	Naylor, J. B. (James Ball)
Naipaul, V. S. (Vidiadhar Surajprasad)	Naipaul, V. S (Vidiadhar Surajprasad)	Naipaul, V. S. (Vidiadhar Surajprasad)
Smith, Harriet L. (Harriet Lummis)	Smith, Harriet L	Smith, Harriet L. (Harriet Lummis)
Smith, C. W. (Charles William)	Smith, C. W (Charles William)	Smith, C. W. (Charles William)
Smith, Alice Prescott, Mrs	Smith, Alice Prescott	Smith, Alice Prescott, Mrs
Smith, W. L. G. (William L. G.)	Smith, W. L. G	Smith, W. L. G. (William L. G.)
Smedley, Frank E. (Frank Edward)	Smedley, Frank E. (Frank Edward)	Smedley, Frank E
Smollett, T. (Tobias)	Smollett, T	Smollett, T. (Tobias)
Smythies, Gordon, Mrs	Smythies, Gordon, Mrs	Smythies, Gordon
Hsiung, S. I. (Shih I)	Hsiung, S. I. (Shih I)	Hsiung, S. I (Shih I)
Tyson, J. Aubrey (John Aubrey)	Tyson, J. Aubrey	Tyson, J. Aubrey (John Aubrey)
Leskov, N. S. (Nikolaĭ Semenovich)	Leskov, N. S (Nikolaĭ Semenovich)	Leskov, N. S. (Nikolaĭ Semenovich)	Leskov, N. S	Leskov, N. S. (Nikolaĭ Semenovich)
Le Clézio, J.-M. G. (Jean-Marie Gustave)	Le Clézio, J.-M. G (Jean-Marie Gustave)	Le Clézio, J.-M. G. (Jean-Marie Gustave)
Lennep, J. van (Jacob van)	Lennep, J. van (Jacob)	Lennep, J. van (Jacob van)
Lee, Edna L. (Mooney)	Lee, Edna L. Mooney	Lee, Edna L. (Mooney)
Lewis, W. S. (Wilmarth Sheldon)	Lewis, W. S	Lewis, W. S. (Wilmarth Sheldon)
Lewis, M. G. (Matthew Gregory)	Lewis, M. G. (Matthew Gregory)	Lewis, M. G
Leach, M. L. (Morgan Lewis)	Leach, M. L. [from old catalog]	Leach, M. L. (Morgan Lewis)
Lee, Jennette Barbour (Perry)	Lee, Jennette Barbour Perry	Lee, Jennette Barbour (Perry)
Leadbeater, C. W. (Charles Webster)	Leadbeater, C. W (Charles Webster)	Leadbeater, C. W. (Charles Webster)
Lewis, C. S. (Clive Staples)	Lewis, C. S. (Clive Staples)	Lewis, C. S (Clive Staples)
Lee, R., Mrs	Lee, R, Mrs	Lee, R., Mrs
Levett Yeats, S. (Sidney)	Levett Yeats, S	Levett Yeats, S. (Sidney)
Levner, I. B. (Israel Benjamin)	Levner, I. B (Israel Benjamin)	Levner, I. B. (Israel Benjamin)
Levere, William C. (William Collin)	Levere, William C. (William Collin)	Levere, William C
Oliphant, (Margaret), Mrs	Oliphant, (Margaret), Mrs	Oliphant, Mrs. (Margaret)
Fénelon, François de Salignac de La Mothe-	Fénelon, François de Salignac de La Mothe-	Fénelon, François de Salignac de la Mothe
baron de, Lamothe-Langon, Étienne Léon	baron de, Lamothe-Langon, Étienne Léon	baron de, Lamothe-Langon, Etienne-Léon	baron de, Lamothe-Langon, Étienne Léon
baronne, Aimery de Pierrebourg, Marguerite (Thomas-Galline)	baronne, Aimery de Pierrebourg, Marguerite (Thomas-Galline)	baronne, Aimery de Pierrebourg, Marguerite Thomas-Galline
baroness, Calabrella, E. C. de	baroness, Calabrella, E. C. de	baroness Calabrella, E. C. de
Richardson, Charles F. (Charles Francis)	Richardson, Charles F	Richardson, Charles F. (Charles Francis)
Riddell, J. H., Mrs	Riddell, J. H., Mrs	Riddell, J. H	Riddell, J. H, Mrs
Richmond, Grace S. (Grace Smith)	Richmond, Grace S. (Grace Smith)	Richmond, Grace S
Richardson, Dorothy M. (Dorothy Miller)	Richardson, Dorothy M. (Dorothy Miller)	Richardson, Dorothy M (Dorothy Miller)	Richardson, Dorothy M	Richardson, Dorothy Miller
Riis, Jacob A. (Jacob August)	Riis, Jacob A (Jacob August)	Riis, Jacob A	Riis, Jacob A. (Jacob August)
Rives, Judith Page (Walker)	Rives, Judith Page Walker	Rives, Judith Page (Walker)
Rice, Edward I. (Edward Irving)	Rice, Edward I. (Edward Irving)	Rice, Edward I
Richardson, Henry Handel, pseud	Richardson, Henry Handel	Richardson, Henry Handel, pseud
Ridge, W. Pett (William Pett)	Ridge, W. Pett (William Pett)	Ridge, W. Pett
Rivers, George R. R. (George Robert Russell)	Rivers, George R. R	Rivers, George R. R. (George Robert Russell)
Richmond, Grace Louise (Smith), Mrs	Richmond, Grace Louise (Smith) Mrs	Richmond, Grace Louise (Smith), Mrs
Richards, Jarrett T. (Jarrett Thomas)	Richards, Jarrett T. (Jarrett Thomas)	Richards, Jarrett T
Porter, Eleanor H. (Eleanor Hodgman)	Porter, Eleanor H. (Eleanor Hodgman)	Porter, Eleanor H
Post, C. C. (Charles Clement)	Post, C. C. (Charles Clement)	Post, C. C
Powell, Addison M. (Addison Monroe)	Powell, Addison M (Addison Monroe)	Powell, Addison M	Powell, Addison M. (Addison Monroe)
Ponder, S. E. G. (Stephen Einar Gilbert)	Ponder, S. E. G. (Stephen Einar Gilbert)	Ponder, S. E. G (Stephen Einar Gilbert)
Poynter, E. Frances (Eleanor Frances)	Poynter, E. Frances (Eleanor Frances)	Poynter, E. Frances
Power, M. S (Maurice S)	Power, M. S (Maurice S)	Power, M. S
Powers, J. F. (James Farl)	Powers, J. F (James Farl)	Powers, J. F. (James Farl)
Post, Helen (Wilmans), Mrs	Post, Helen (Wilmans)	Post, Helen (Wilmans), Mrs
Powell, G. H. (George Herbert)	Powell, G. H	Powell, G. H. (George Herbert)
Porter, Rebecca N. (Rebecca Newman)	Porter, Rebecca N. (Rebecca Newman)	Porter, Rebecca N
Pollock, Frederick, Sir	Pollock, Frederick	Pollock, Frederick, Sir
Stephens, Ann S. (Ann Sophia)	Stephens, Ann S	Stephens, Ann S. (Ann Sophia)
St. John, Percy B. (Percy Bolingbroke)	St. John, Percy B (Percy Bolingbroke)	St. John, Percy B. (Percy Bolingbroke)
Stewart, Elinore (Pruitt)	Stewart, Elinore Pruitt	Stewart, Elinore (Pruitt)
Stauffer, Donald A. (Donald Alfred)	Stauffer, Donald A (Donald Alfred)	Stauffer, Donald A. (Donald Alfred)
Stephens, C. A. (Charles Asbury)	Stephens, C. A	Stephens, C. A. (Charles Asbury)
St. Johnston, Thomas Reginald, Sir	St. Johnston, Thomas Reginald	St. Johnston, Thomas Reginald, Sir
Stribling, T. S. (Thomas Sigismund)	Stribling, T. S	Stribling, T. S. (Thomas Sigismund)	Stribling, T. S (Thomas Sigismund)
Stacpoole, H. De Vere (Henry De Vere)	Stacpoole, H. De Vere	Stacpoole, H. De Vere (Henry De Vere)
Stead, W. T. (William Thomas)	Stead, W. T	Stead, W. T. (William Thomas)
Stanley, Henry M. (Henry Morton)	Stanley, Henry M. (Henry Morton)	Stanley, Henry M
Stellman, Louis J. (Louis John)	Stellman, Louis J	Stellman, Louis J. (Louis John)
Stephens, H. Marion (Harriet Marion)	Stephens, H. Marion (Harriet Marion)	Stephens, H. Marion
Stearns, J. N. (John Newton)	Stearns, J. N	Stearns, J. N. (John Newton)
Stevens, Charles W. (Charles Woodbury)	Stevens, Charles W. (Charles Woodbury)	Stevens, Charles W
Strong, L. A. G. (Leonard Alfred George)	Strong, L. A. G (Leonard Alfred George)	Strong, L. A. G. (Leonard Alfred George)
Stone, William A. (William Alexis)	Stone, William A. (William Alexis)	Stone, William A (William Alexis)
Street, G. S. (George Slythe)	Street, G. S. (George Slythe)	Street, G. S
Stretton, Hesba	Stretton, Hesba	Stretton,Hesba
Stern, G. B. (Gladys Bronwyn)	Stern, G. B	Stern, G. B (Gladys Bronwyn)	Stern, G. B. (Gladys Bronwyn)
Stacpoole, Margaret (Robson), Mrs	Stacpoole, Margaret (Robson), Mrs	Stacpoole, Margaret (Robson)
Steevens, G. W. (George Warrington)	Steevens, G. W. (George Warrington)	Steevens, G. W
Stuefloten, D. N. (Donald N.)	Stuefloten, D. N. (Donald N.)	Stuefloten, D. N (Donald N.)
Stead, C. K. (Christian Karlson)	Stead, C. K. (Christian Karlson)	Stead, C. K (Christian Karlson)
Stimson, Frederic Jessup	Stimson, Frederic Jessup	Stimson, Frederic Jesup
Stockton, Frank R. (Frank Richard)	Stockton, Frank R. (Frank Richard)	Stockton, Frank R
Stanley, Caroline (Abbot), Mrs	Stanley, Caroline Abbot	Stanley, Caroline (Abbot), Mrs
Steuart, John A. (John Alexander)	Steuart, John A	Steuart, John A. (John Alexander)
Stenhouse, T. B. H, Mrs	Stenhouse, T. B. H	Stenhouse, T. B. H, Mrs
Steele, James W. (James William)	Steele, James W. (James William)	Steele, James W
Stephen, Harry Lushington, Sir	Stephen, Harry Lushington	Stephen, Harry Lushington, Sir
Stewart, J. I. M. (John Innes Mackintosh)	Stewart, J. I. M. (John Innes Mackintosh)	Stewart, J. I. M (John Innes Mackintosh)
Street, James H. (James Howell)	Street, James H. (James Howell)	Street, James H (James Howell)
Strauss, L. F. (Leopold Frederick)	Strauss, L. F. (Leopold Frederick)	Strauss, L. F
Strong, James C. (James Clark)	Strong, James C. (James Clark)	Strong, James C
Stewart, Charles D. (Charles David)	Stewart, Charles D. (Charles David)	Stewart, Charles D
Strain, E. H. (Euphans H.)	Strain, E. H. (Euphans H.)	Strain, E. H
freifrau von, Tautphœus, Jemima (Montgomery)	freifrau von, Tautphœus, Jemima Montgomery	freifrau von, Tautphœus, Jemima (Montgomery)
friherrinna, Aminoff, Constance Léonie Caroline Borgström	friherrinna, Aminoff, Constance Leonie Caroline Borgström	friherrinna, Aminoff, Constance Léonie Caroline Borgström
Fischer, Henry W. (Henry William)	Fischer, Henry W. (Henry William)	Fischer, Henry W
Field, Isobel (Osbourne), Mrs	Field, Isobel Osbourne	Field, Isobel (Osbourne), Mrs
Fitchett, W. H. (William Henry)	Fitchett, W. H. (William Henry)	Fitchett, W. H
Findlater, Jane Helen	Findlater, Jane Helen	Findlater Jane Helen
Fisher, Anne (Benson) Mrs	Fisher, Anne Benson	Fisher, Anne (Benson) Mrs
Field, Henrietta (Dexter), Mrs	Field, Henrietta (Dexter), Mrs	Field, Henrietta (Dexter)
Finney, Charles G. (Charles Grandison)	Finney, Charles G. (Charles Grandison)	Finney, Charles G (Charles Grandison)
Fielding, H. (Harold)	Fielding, H	Fielding, H. (Harold)
Aswell, Mary Louise (White)	Aswell, Mary Louise (White)	Aswell, Mary Louise White
Pyne, W. H. (William Henry)	Pyne, W. H. (William Henry)	Pyne, W. H
Tiernan, Frances Christine (Fisher), Mrs	Tiernan, Frances Christine (Fisher), Mrs	Tiernan, Frances Christine (Fisher)
Cutting, Mary Stewart Doubleday	Cutting, Mary Stewart Doubleday	Cutting, Mary Stewart
Cunningham, H. S. (Henry Stewart), Sir	Cunningham, H. S	Cunningham, H. S. (Henry Stewart), Sir
Cunninghame Graham, R. B. (Robert Bontine)	Cunninghame Graham, R. B. (Robert Bontine)	Cunninghame Graham, R. B (Robert Bontine)	Cunninghame Graham, R. B
Cummins, Maria S. (Maria Susanna)	Cummins, Maria S. (Maria Susanna)	Cummins, Maria S
Cunningham, J. W. (John William)	Cunningham, J. W	Cunningham, J. W. (John William)
Gleig, G. R. (George Robert)	Gleig, G. R	Gleig, G. R. (George Robert)
Glascock, W. N. (William Nugent)	Glascock, W. N. (William Nugent)	Glascock, W. N
O'Connor, T. P., Mrs	O'Connor, T. P	O'Connor, T. P, Mrs	O'Connor, T. P., Mrs
O'Brien, Edward J. (Edward Joseph)	O'Brien, Edward J. (Edward Joseph)	O'Brien, Edward J
O'Sullivan, Denis, Mrs	O'Sullivan, Denis	O'Sullivan, Denis, Mrs
Davies, E. Chivers (Ellen Chivers)	Davies, E. Chivers (Ellen Chivers)	Davies, E. Chivers
Dallas, Mary (Kyle)	Dallas, Mary Kyle	Dallas, Mary (Kyle)
Daniels, Mabel W. (Mabel Wheeler)	Daniels, Mabel W. (Mabel Wheeler)	Daniels, Mabel W
Davis, M. E. M. (Mollie Evelyn Moore)	Davis, M. E. M. (Mollie Evelyn Moore)	Davis, M. E. M
Davies, W. H. (William Henry)	Davies, W. H. (William Henry)	Davies, W. H
Darton, F. J. Harvey (Frederick Joseph Harvey)	Darton, F. J. Harvey	Darton, F. J. Harvey (Frederick Joseph Harvey)
Davis, J. Frank, (James Francis)	Davis, J. Frank, (James Francis)	Davis, J. Frank (James Francis)
Davis, Edith (Smith)	Davis, Edith Smith	Davis, Edith (Smith)
Dawson, W. J. (William James)	Dawson, W. J. (William James)	Dawson, W. J (William James)	Dawson, W. J
Daggett, Mary (Stewart), Mrs	Daggett, Mary (Stewart)	Daggett, Mary (Stewart), Mrs
Dasent, George Webbe, Sir	Dasent, George Webbe, Sir	Dasent, George Webbe
Viramontes, Helena María	Viramontes, Helena Maria	Viramontes, Helena María
Viscount, Slim, William Joseph Slim	Viscount, Slim, William Slim	Viscount, Slim, William Joseph Slim
Linevskiĭ, A. (Aleksandr)	Linevskiĭ, A. (Aleksandr)	Linevskiĭ, A (Aleksandr)
Lighton, William R. (William Rheem)	Lighton, William R. (William Rheem)	Lighton, William R
Libedinskiĭ, I͡U. (I͡Uriĭ)	Libedinskiĭ, I͡U (I͡Uriĭ)	Libedinskiĭ, I͡U. (I͡Uriĭ)
Linton, E. Lynn (Elizabeth Lynn)	Linton, E. Lynn (Elizabeth Lynn)	Linton, E. Lynn
Lipsett,  H. Caldwell	Lipsett,  H. Caldwell	Lipsett, H. Caldwell
Livingstone, W. P. (William Pringle)	Livingstone, W. P. (William Pringle)	Livingstone, W. P
Kyne, Peter B. (Peter Bernard)	Kyne, Peter B. (Peter Bernard)	Kyne, Peter B
Robinson, William J. (William Josephus)	Robinson, William J	Robinson, William J. (William Josephus)
Robinson, H. Perry (Harry Perry)	Robinson, H. Perry	Robinson, H. Perry (Harry Perry)
Roberts, S. C. (Sydney Castle)	Roberts, S. C. (Sydney Castle)	Roberts, S. C (Sydney Castle)
Roberts, C. E. Bechhofer (Carl Eric Bechhofer)	Roberts, C. E. Bechhofer (Carl Eric Bechhofer)	Roberts, C. E. Bechhofer
Rosenbach, A. S. W. (Abraham Simon Wolf)	Rosenbach, A. S. W	Rosenbach, A. S. W. (Abraham Simon Wolf)
Roe, Frances Marie Antoinette Mack	Roe, Frances Marie Antoinette Mack	Roe, Frances Marie Antoinette
Roe, Vingie E. (Vingie Eve)	Roe, Vingie E	Roe, Vingie E. (Vingie Eve)
Robinson, Eliot H. (Eliot Harlow)	Robinson, Eliot H. (Eliot Harlow)	Robinson, Eliot H
Robinson, F. W. (Frederick William)	Robinson, F. W. (Frederick William)	Robinson, F. W
Root, Esther Sayles	Root, Esther Sayles. [from old catalog]	Root, Esther Sayles
Roland Wilkins. Wilkins, Louisa (Jebb), Mrs	Roland Wilkins. Wilkins, Louisa Jebb, Mrs	Roland Wilkins. Wilkins, Louisa (Jebb), Mrs
Robbins, Sarah Stuart, Mrs	Robbins, Sarah Stuart	Robbins, Sarah Stuart, Mrs
Roberts, Charles G. D., Sir	Roberts, Charles G. D., Sir	Roberts, Charles G. D, Sir	Roberts, Charles G. D
Roberts, Charles George Douglas, Sir	Roberts, Charles George Douglas, Sir	Roberts, Charles George Douglas
Adams, Emma H. (Emma Hildreth)	Adams, Emma H	Adams, Emma H. (Emma Hildreth)
Adams, W. H. Davenport (William Henry Davenport)	Adams, W. H. Davenport (William Henry Davenport)	Adams, W. H. Davenport
Adams, John S. (John Stowell)	Adams, John S. (John Stowell)	Adams, John S
Adams, Frank R. (Frank Ramsay)	Adams, Frank R. (Frank Ramsay)	Adams, Frank R
Aksakov, S. T. (Sergeĭ Timofeevich)	Aksakov, S. T. (Sergeĭ Timofeevich)	Aksakov, S. T	Aksakov, S. T. (Sergeĭ Timofeevich)	Aksakov, S. T (Sergeĭ Timofeevich)
Idriess, Ion L. (Ion Llewellyn)	Idriess, Ion L. (Ion Llewellyn)	Idriess, Ion L (Ion Llewellyn)
Umbstaetter, H. D. (Herman Daniel)	Umbstaetter, H. D	Umbstaetter, H. D. (Herman Daniel)
Snaith, J. C. (John Collis)	Snaith, J. C. (John Collis)	Snaith, J. C
Snow, C. P. (Charles Percy)	Snow, C. P. (Charles Percy)	Snow, C. P (Charles Percy)
Snell, Roy J. (Roy Judson)	Snell, Roy J	Snell, Roy J. (Roy Judson)
Snider, C. H. J. (Charles Henry Jeremiah)	Snider, C. H. J. (Charles Henry Jeremiah)	Snider, C. H. J
Snyder, Charles M. (Charles McCoy)	Snyder, Charles M	Snyder, Charles M. (Charles McCoy)
Fosdick, W. W. (William Whiteman)	Fosdick, W. W	Fosdick, W. W. (William Whiteman)
Fortescue, J. W. (John William), Sir	Fortescue, J. W	Fortescue, J. W. (John William), Sir
Forster, E. M. (Edward Morgan)	Forster, E. M (Edward Morgan)	Forster, E. M. (Edward Morgan)
Fowler, W. Warde (William Warde)	Fowler, W. Warde	Fowler, W. Warde (William Warde)
Foote, Mary (Hallock), Mrs	Foote, Mary Hallock	Foote, Mary (Hallock), Mrs
Forester, C. S. (Cecil Scott)	Forester, C. S (Cecil Scott)	Forester, C. S. (Cecil Scott)
Foster, Charles J. (Charles James)	Foster, Charles J. (Charles James)	Foster, Charles J
Foster, R. F. (Robert Frederick)	Foster, R. F	Foster, R. F. (Robert Frederick)
Fowler, Nathaniel C. (Nathaniel Clark)	Fowler, Nathaniel C	Fowler, Nathaniel C. (Nathaniel Clark)
Sweetser, Kate Dickinson	Sweetser, Kate Dickinson	Sweetser, Kate Dickinson. [from old catalog]
Swinton, E. D. (Ernest Dunlop)	Swinton, E. D (Ernest Dunlop)	Swinton, E. D. (Ernest Dunlop)
Swettenham, Frank Athelstane, Sir	Swettenham, Frank Athelstane, Sir	Swettenham, Frank Athelstane
Swanson, Neil H. (Neil Harmon)	Swanson, Neil H. (Neil Harmon)	Swanson, Neil H (Neil Harmon)
Tarbell, Ida M. (Ida Minerva)	Tarbell, Ida M	Tarbell, Ida M (Ida Minerva)	Tarbell, Ida M. (Ida Minerva)
Tapp, Sidney C. (Sidney Calhoun)	Tapp, Sidney C. (Sidney Calhoun)	Tapp, Sidney C
Tarasov-Rodionov, A. (Aleksandr)	Tarasov-Rodionov, A (Aleksandr)	Tarasov-Rodionov, A. (Aleksandr)
Taber, Louise E. (Louise Edgar)	Taber, Louise E. (Louise Edgar)	Taber, Louise E
Talmage, T. De Witt (Thomas De Witt)	Talmage, T. De Witt	Talmage, T. De Witt (Thomas De Witt)
Ervine, St. John G. (St. John Greer)	Ervine, St. John G	Ervine, St. John G. (St. John Greer)
Klette, C. H. B. (Charles Herman Bruno)	Klette, C. H. B. (Charles Herman Bruno)	Klette, C. H. B
Kluge, P. F. (Paul Frederick)	Kluge, P. F. (Paul Frederick)	Kluge, P. F (Paul Frederick)
Squire, John Collings, Sir	Squire, John Collings	Squire, John Collings, Sir
Clarke, Arthur C.   (Arthur Charles)	Clarke, Arthur C.   (Arthur Charles)	Clarke, Arthur C. (Arthur Charles)	Clarke, Arthur C (Arthur Charles)
Clarke, Mary Cowden, Mrs	Clarke, Mary Cowden, Mrs	Clarke, Mary Cowden
Clouston, J. Storer (Joseph Storer)	Clouston, J. Storer (Joseph Storer)	Clouston, J. Storer
Clouston, W. A. (William Alexander)	Clouston, W. A. (William Alexander)	Clouston, W. A (William Alexander)	Clouston, W. A
Clifford, W. K., Mrs	Clifford, W. K., Mrs	Clifford, W. K, Mrs	Clifford, W. K
Clifford, Hugh Charles, Sir	Clifford, Hugh Charles, Sir	Clifford, Hugh Charles
Clark, Barrett H. (Barrett Harper)	Clark, Barrett H. (Barrett Harper)	Clark, Barrett H (Barrett Harper)
Clowes, W. Laird (William Laird), Sir	Clowes, W. Laird (William Laird), Sir	Clowes, W. Laird
Clinkscales, J. G. (John George)	Clinkscales, J. G. (John George)	Clinkscales, J. G
Clancy, Louise Marks Breitenbach, Mrs	Clancy, Louise Marks Breitenbach, Mrs	Clancy, Louise Marks Breitenbach
Clark, Thomas M. (Thomas March)	Clark, Thomas M. (Thomas March)	Clark, Thomas M
Clarke, Ida Clyde Gallagher, Mrs	Clarke, Ida Clyde (Gallagher)	Clarke, Ida Clyde Gallagher	Clarke, Ida Clyde Gallagher, Mrs
Lytton, Edward Bulwer Lytton, Baron	Lytton, Edward Bulwer Lytton	Lytton, Edward Bulwer Lytton, Baron
Lydston, G. Frank (George Frank)	Lydston, G. Frank	Lydston, G. Frank (George Frank)
Lyons, A. Neil (Albert Neil)	Lyons, A. Neil	Lyons, A. Neil (Albert Neil)
Lyle, Eugene P. (Eugene Percy)	Lyle, Eugene P	Lyle, Eugene P. (Eugene Percy)
Lyman, Olin L. (Olin Linus)	Lyman, Olin L. (Olin Linus)	Lyman, Olin L
Miller, Helen (Topping)	Miller, Helen Topping	Miller, Helen (Topping)
Mitchell, W. O. (William Ormond)	Mitchell, W. O. (William Ormond)	Mitchell, W. O (William Ormond)
Mitchell, S. Weir (Silas Weir)	Mitchell, S. Weir (Silas Weir)	Mitchell, S. Weir
Mitton, G. E. (Geraldine Edith)	Mitton, G. E. (Geraldine Edith)	Mitton, G. E
Michener, James A. (James Albert)	Michener, James A. (James Albert)	Michener, James A (James Albert)
Miln, Louise (Jordan), Mrs	Miln, Louise (Jordan), Mrs	Miln, Louise (Jordan)	Miln, Louise Jordan	Miln, Louise Jordan, Mrs
Mitchell, Lucy (Sprague)	Mitchell, Lucy Sprague	Mitchell, Lucy (Sprague)
Miller, Harriet (Mann)	Miller, Harriet Mann	Miller, Harriet (Mann)
Miller, Alice Duer, Mrs	Miller, Alice Duer	Miller, Alice Duer, Mrs
Mitchell, William, Sir	Mitchell, William	Mitchell, William, Sir
Mihesuah, Devon A. (Devon Abbott)	Mihesuah, Devon A (Devon Abbott)	Mihesuah, Devon A. (Devon Abbott)
Milne, A. A. (Alan Alexander)	Milne, A. A. (Alan Alexander)	Milne, A. A	Milne, A. A (Alan Alexander)
Minney, R. J. (Rubeigh James)	Minney, R. J (Rubeigh James)	Minney, R. J. (Rubeigh James)	Minney, R. J
Miller, D. L, Mrs	Miller, D. L	Miller, D. L, Mrs
Miller, George Amos, Bishop	Miller, George Amos, Bishop	Miller, George Amos, bp
Milman, E. A. (Edward Augustus)	Milman, E. A. (Edward Augustus)	Milman, E. A
McGary, Elizabeth Vis??re	McGary, Elizabeth Vis??re	McGary, Elizabeth Visère	McGary, Elizabeth Vis??re. [from old catalog]
McCutcheon, John T. (John Tinney)	McCutcheon, John T. (John Tinney)	McCutcheon, John T
McNaught, Rosamond (Livingstone), Mrs	McNaught, Rosamond (Livingstone), Mrs	McNaught, Rosamond (Livingstone)	McNaught, Rosamond Livingstone
McKeever, Harriet B. (Harriet Burn)	McKeever, Harriet B	McKeever, Harriet B. (Harriet Burn)
McCarthy, Justin H , (Justin Huntly)	McCarthy, Justin H , (Justin Huntly)	McCarthy, Justin H	McCarthy, Justin H. (Justin Huntly)
McLaren, Jack, Mrs	McLaren, Jack, Mrs	McLaren, Jack
McNeal, T. A. (Thomas Allen)	McNeal, T. A	McNeal, T. A. (Thomas Allen)
McClure, J. B. (James Baird)	McClure, J. B. (James Baird)	McClure, J. B
McDonald, Etta Austin (Blaisdell), Mrs	McDonald, Etta Austin (Blaisdell)	McDonald, Etta Austin (Blaisdell), Mrs	McDonald, Etta Austin Blaisdell
McSpadden, J. Walker (Joseph Walker)	McSpadden, J. Walker	McSpadden, J. Walker (Joseph Walker)
McIntosh, Maria J. (Maria Jane)	McIntosh, Maria J	McIntosh, Maria J. (Maria Jane)
McKeown, Martha (Ferguson)	McKeown, Martha Ferguson	McKeown, Martha (Ferguson)
McNeile, H. C. (Herman Cyril)	McNeile, H. C	McNeile, H. C. (Herman Cyril)
Helps, Arthur, Sir	Helps, Arthur	Helps, Arthur, Sir
Hegermann-Lindencrone, L. de (Lillie de)	Hegermann-Lindencrone, L. de (Lillie de)	Hegermann-Lindencrone, L. de
Herbert, A. P. Sir, (Alan Patrick)	Herbert, A. P. (Alan Patrick)	Herbert, A. P	Herbert, A. P. Sir, (Alan Patrick)	Herbert, A. P. (Alan Patrick), Sir	Herbert, A. P (Alan Patrick)
Henderson, W. J. (William James)	Henderson, W. J. (William James)	Henderson, W. J
Hewlett, J. (Joseph)	Hewlett, J	Hewlett, J. (Joseph)
Henty, G. A. (George Alfred)	Henty, G.A. (George Alfred)	Henty, G. A	Henty, G. A. (George Alfred)	Henty, G. A (George Alfred)
Heaton, Eliza Osborn (Putnam), Mrs	Heaton, Eliza Osborn (Putnam), Mrs	Heaton, Eliza Osborn (Putnam)
Henry, Alfred H. (Alfred Hylas)	Henry, Alfred H. (Alfred Hylas)	Henry, Alfred H
Herring, J. L. (John Lewis)	Herring, J. L. (John Lewis)	Herring, J. L
Hermann, I. (Isaac)	Hermann, I. (Isaac)	Hermann, I
Heinlein, Robert A. (Robert Anson)	Heinlein, Robert A. (Robert Anson)	Heinlein, Robert A (Robert Anson)
Henriques, Robert David, Quixano	Henriques, Robert David, Quixano	Henriques, Robert David Quixano
Head, Francis Bond, Sir	Head, Francis Bond, Sir	Head, Francis Bond
Head, George, Sir	Head, George	Head, George, Sir
Henderson, B. L. K. (Bernard Lionel Kinghorn)	Henderson, B. L. K	Henderson, B. L. K. (Bernard Lionel Kinghorn)
Heath, W. L. (William L.)	Heath, W. L. (William L.)	Heath, W. L (William L.)
Rølvaag, O. E. (Ole Edvart)	Rølvaag, O. E (Ole Edvart)	Rølvaag, O. E. (Ole Edvart)
Bruce, H. Addington (Henry Addington)	Bruce, H. Addington	Bruce, H. Addington (Henry Addington)
Brimblecom, Charles E.	Brimblecom, Charles E. [from old catalog]	Brimblecom, Charles E
Bronson, Wilfrid S. (Wilfrid Swancourt)	Bronson, Wilfrid S. (Wilfrid Swancourt)	Bronson, Wilfrid S (Wilfrid Swancourt)
Bridges, John A. (John Affleck)	Bridges, John A. (John Affleck)	Bridges, John A
Brooks, Elbridge S. (Elbridge Streeter)	Brooks, Elbridge S	Brooks, Elbridge S. (Elbridge Streeter)
Brooks, Charles S. (Charles Stephen)	Brooks, Charles S	Brooks, Charles S. (Charles Stephen)
Brown, H. E. (Helen E.)	Brown, H. E. (Helen E.)	Brown, H. E
Brush, Christine C. (Christine Chaplin)	Brush, Christine C. (Christine Chaplin)	Brush, Christine C
Brown, A. E. (Abram English)	Brown, A. E. (Abram English)	Brown, A. E (Abram English)	Brown, A. E
Braithwaite, E. R. (Edward Ricardo)	Braithwaite, E. R (Edward Ricardo)	Braithwaite, E. R. (Edward Ricardo)
Bruckberger, R.-L. (Raymond-Léopold)	Bruckberger, R.-L. (Raymond-Léopold)	Bruckberger, R.-L. (Raymond-Léopold)
Braddon, M. E. (Mary Elizabeth)	Braddon, M. E	Braddon, M. E. (Mary Elizabeth)	Braddon, M. E (Mary Elizabeth)
Brink, André P. (André Philippus)	Brink, André P (André Philippus)	Brink, André P. (André Philippus)
Brereton, F. S. (Frederick Sadleir)	Brereton, F. S	Brereton, F. S. (Frederick Sadleir)
Britton, Alfred Dudley	Britton, Alfred Dudley, [from old catalog]	Britton, Alfred Dudley
Brown, james	Brown, james	Brown, James
Bradley-Birt, F. B. (Francis Bradley)	Bradley-Birt, F. B. (Francis Bradley)	Bradley-Birt, F. B
Brock, Carey, Mrs	Brock, Carey	Brock, Carey, Mrs
Brydges, Egerton, Sir	Brydges, Egerton, Sir	Brydges, Egerton
Brookfield, Charles H. E (Charles Hallam Elton)	Brookfield, Charles H. E (Charles Hallam Elton)	Brookfield, Charles H. E
Bradby, G. F. (Godfrey Fox)	Bradby, G. F	Bradby, G. F. (Godfrey Fox)
Bradley, Mary E. (Mary Emily)	Bradley, Mary E. (Mary Emily)	Bradley, Mary E
Broster, D. K. (Dorothy Kathleen)	Broster, D. K	Broster, D. K. (Dorothy Kathleen)
Branner, H. C. (Hans Christian)	Branner, H. C (Hans Christian)	Branner, H. C. (Hans Christian)
Brainerd, Eleanor (Hoyt), Mrs	Brainerd, Eleanor Hoyt	Brainerd, Eleanor (Hoyt), Mrs	Brainerd, Eleanor (Hoyt)
Weld, H. Hastings (Horatio Hastings)	Weld, H. Hastings (Horatio Hastings)	Weld, H. Hastings
Wetmore, Claude H. (Claude Hazeltine)	Wetmore, Claude H. (Claude Hazeltine)	Wetmore, Claude H (Claude Hazeltine)
Westervelt, W. D (William Drake)	Westervelt, W. D	Westervelt, W. D (William Drake)
Wells, H. G. (Herbert George)	Wells, H. G	Wells, H. G (Herbert George)	Wells, H. G. (Herbert George)
Wedmore, Frederick, Sir	Wedmore, Frederick	Wedmore, Frederick, Sir
West, (Jane), Mrs	West, (Jane), Mrs	West, Jane
Webber, Charles W. (Charles Wilkins)	Webber, Charles W	Webber, Charles W (Charles Wilkins)	Webber, Charles W. (Charles Wilkins)
Welles, Harriet Ogden (Deen), Mrs	Welles, Harriet Ogden (Deen), Mrs	Welles, Harriet Ogden (Deen)
Weaver, John V. A. (John Van Alstyne)	Weaver, John V. A	Weaver, John V. A. (John Van Alstyne)
Wellman, Paul I. (Paul Iselin)	Wellman, Paul I. (Paul Iselin)	Wellman, Paul I (Paul Iselin)
Weir, Florence (Roney), Mrs	Weir, Florence (Roney)	Weir, Florence (Roney), Mrs	Weir, Florence Roney
Weiskopf, F. C. (Franz Carl)	Weiskopf, F. C. (Franz Carl)	Weiskopf, F. C (Franz Carl)
Grenfell, Wilfred Thomason, Sir	Grenfell, Wilfred Thomason	Grenfell, Wilfred Thomason, Sir
Griggs, Sutton E.   (Sutton Elbert)	Griggs, Sutton E (Sutton Elbert)	Griggs, Sutton E.   (Sutton Elbert)	Griggs, Sutton E	Griggs, Sutton E. (Sutton Elbert)
Grenfell, Anna Elizabeth Caldwell (MacClanahan)	Grenfell, Anna Elizabeth Caldwell (MacClanahan)	Grenfell, Anna Elizabeth Caldwell MacClanahan
Graves, Charles L. (Charles Larcom)	Graves, Charles L	Graves, Charles L. (Charles Larcom)
Grey, (Elizabeth Caroline), Mrs	Grey, Elizabeth Caroline	Grey, (Elizabeth Caroline), Mrs
Gratacap, L. P. (Louis Pope)	Gratacap, L. P. (Louis Pope)	Gratacap, L. P
Grant Watson, Elliot L. (Elliot Lovegood)	Grant Watson, Elliot L	Grant Watson, Elliot L. (Elliot Lovegood)
Griggs, S. E. (Stephen Elind)	Griggs, S. E. (Stephen Elind)	Griggs, S. E
Greg, William R. (William Rathbone)	Greg, William R. (William Rathbone	Greg, William R	Greg, William R. (William Rathbone)
Grigorovich, D. V. (Dmitriĭ Vasilʹevich)	Grigorovich, D. V. (Dmitriĭ Vasilʹevich)	Grigorovich, D. V (Dmitriĭ Vasilʹevich)
Grosvenor, Abbie (Johnston)	Grosvenor, Abbie Johnston	Grosvenor, Abbie (Johnston)
Ramarau, Rama V. M. G.	Ramarau, Rama V M G	Ramarau, Rama V. M. G
Ravage, M. E. (Marcus Eli)	Ravage, M. E (Marcus Eli)	Ravage, M. E. (Marcus Eli)	Ravage, M. E
Rafy, K U, Mrs	Rafy, K U, Mrs	Rafy, K U
Ramsay, Robert L., (Robert Lee)	Ramsay, Robert L., (Robert Lee)	Ramsay, Robert L
Raj Rao, R. (Ramachandrapurapu)	Raj Rao, R. (Ramachandrapurapu)	Raj Rao, R (Ramachandrapurapu)
Ramuz, C. F. (Charles Ferdinand)	Ramuz, C. F (Charles Ferdinand)	Ramuz, C. F. (Charles Ferdinand)
Rawnsley, H. D. (Hardwicke Drummond)	Rawnsley, H. D	Rawnsley, H. D. (Hardwicke Drummond)
Rak, Mary Kidder, Mrs	Rak, Mary Kidder	Rak, Mary Kidder, Mrs
Rattray, R. S. (Robert Sutherland)	Rattray, R. S. (Robert Sutherland)	Rattray, R. S (Robert Sutherland)
Rand, Edward A. (Edward Augustus)	Rand, Edward A	Rand, Edward A. (Edward Augustus)
Racovița, Elena (von Dönniges)	Racovița, Elena (von Dönniges)	Racovița, Elena (von Dönniges)
Myers, L. H. (Leopold Hamilton)	Myers, L. H. (Leopold Hamilton)	Myers, L. H (Leopold Hamilton)
Myers, P. Hamilton (Peter Hamilton)	Myers, P. Hamilton	Myers, P. Hamilton (Peter Hamilton)
Voynich, E. L. (Ethel Lillian)	Voynich, E. L. (Ethel Lillian)	Voynich, E. L
Orton, J. R. (Jason Rockwood)	Orton, J. R	Orton, J. R. (Jason Rockwood)
Zeyneb, Hanum	Zeyneb, Hanum	Zeyneb, hanum
Hutchinson, R. C. (Ray Coryton)	Hutchinson, R. C. (Ray Coryton)	Hutchinson, R. C (Ray Coryton)
Hull, Helen R. (Helen Rose)	Hull, Helen R. (Helen Rose)	Hull, Helen R (Helen Rose)
Hutchinson, Horace G. (Horace Gordon)	Hutchinson, Horace G. (Horace Gordon)	Hutchinson, Horace G
Hume, John F. (John Ferguson)	Hume, John F. (John Ferguson)	Hume, John F
Hudson, William C. (William Cadwalader)	Hudson, William C	Hudson, William C. (William Cadwalader)
Hulburd, E. W. (Ebenezer Wallace)	Hulburd, E. W. (Ebenezer Wallace)	Hulburd, E. W
Hull, Mary H.	Hull, Mary H. [from old catalog]	Hull, Mary H
Hughes, James L. (James Laughlin)	Hughes, James L. (James Laughlin)	Hughes, James L
Huysmans, J.-K. (Joris-Karl)	Huysmans, J.-K (Joris-Karl)	Huysmans, J.-K. (Joris-Karl)
Humphrey, Frank Pope, Mrs	Humphrey, Frank Pope	Humphrey, Frank Pope, Mrs
Hudson, Mary W. (Mary Worrell)	Hudson, Mary W	Hudson, Mary W. (Mary Worrell)
Hudson, W. H. (William Henry)	Hudson, W. H (William Henry)	Hudson, W. H. (William Henry)	Hudson, W. H
Hutchinson, A. S. M. (Arthur Stuart-Menteth)	Hutchinson, A. S. M	Hutchinson, A. S. M. (Arthur Stuart-Menteth)
Hunter, William Wilson, Sir	Hunter, William Wilson, Sir	Hunter, William Wilson
Atkinson, Eleanor (Stockhouse), Mrs	Atkinson, Mrs. Eleanor Stackhouse	Atkinson, Eleanor (Stockhouse), Mrs	Atkinson, Eleanor (Stackhouse), Mrs	Atkinson, Eleanor (Stackhouse)
Atkinson, J. C. (John Christopher)	Atkinson, J. C	Atkinson, J. C. (John Christopher)
Luke, Jemima (Thompson)	Luke, Jemima (Thompson)	Luke, Jemima Thompson
Lucas, E. V. (Edward Verrall)	Lucas, E. V	Lucas, E. V. (Edward Verrall)
Montagu, Mary Wortley, Lady	Montagu, Mary Wortley	Montagu, Mary Wortley, Lady
Morris, Harrison S. (Harrison Smith)	Morris, Harrison S. (Harrison Smith)	Morris, Harrison S
Molesworth, Mrs	Molesworth, Mrs	Molesworth
Morgan, J. H. (John Hartman)	Morgan, J. H. (John Hartman)	Morgan, J. H
Morris, I. V. (Ira Victor)	Morris, I. V. (Ira Victor)	Morris, I. V (Ira Victor)
Moore, G. Greville (George Greville)	Moore, G. Greville	Moore, G. Greville (George Greville)
More, Thomas, Sir, Saint	More, Thomas, Sir, Saint	More, Thomas, Saint
Montague, C. E. (Charles Edward)	Montague, C. E	Montague, C. E (Charles Edward)	Montague, C. E. (Charles Edward)
Moore, H. J, Mrs	Moore, H. J	Moore, H. J, Mrs
Morgan, Beatrice (Burton) Mrs	Morgan, Beatrice Burton	Morgan, Beatrice (Burton) Mrs
Moore, T. Sturge (Thomas Sturge)	Moore, T. Sturge (Thomas Sturge)	Moore, T. Sturge
Montgomery, L. M. (Lucy Maud)	Montgomery, L. M. (Lucy Maud)	Montgomery, L. M	Montgomery, L. M (Lucy Maud)
Montgomery, Rutherford G. (Rutherford George)	Montgomery, Rutherford George	Montgomery, Rutherford G. (Rutherford George)
Moffat, Edward S. (Edward Stewart)	Moffat, Edward S	Moffat, Edward S. (Edward Stewart)
Mottram, R. H. (Ralph Hale)	Mottram, R. H. (Ralph Hale)	Mottram, R. H (Ralph Hale)
Molloy, J. Fitzgerald (Joseph Fitzgerald)	Molloy, J. Fitzgerald	Molloy, J. Fitzgerald (Joseph Fitzgerald)
Ekvall, Robert B. (Robert Brainerd)	Ekvall, Robert B (Robert Brainerd)	Ekvall, Robert B. (Robert Brainerd)
Veresaev, V. V. (Vikentiĭ Vikentʹevich)	Veresaev, V. V. (Vikentii Vikentevich)	Veresaev, V. V (Vikentiĭ Vikentʹevich)	Veresaev, V. V. (Vikentiĭ Vikentʹevich)	Veresaev, V. V
Ryan, P. F. William (Patrick Francis William)	Ryan, P. F. William (Patrick Francis William)	Ryan, P.F. William	Ryan, P. F. William
Emerson, P. H. (Peter Henry)	Emerson, P. H. (Peter Henry)	Emerson, P. H
Flygare-Carlén, Emilie (Smith)	Flygare-Carlén, Emilie (Smith)	Flygare-Carlén, Emilie
Flagg, E. E. (Elizabeth E.)	Flagg, E. E	Flagg, E. E. (Elizabeth E.)
Fletcher, J. S. (Joseph Smith)	Fletcher, J. S. (Joseph Smith)	Fletcher, J. S (Joseph Smith)	Fletcher, J. S
Afanasʹev, A. N. (Aleksandr Nikolaevich)	Afanasʹev, A. N. (Aleksandr Nikolaevich)	Afanasʹev, A. N (Aleksandr Nikolaevich)
Ferguson, Samuel, Sir	Ferguson, Samuel	Ferguson, Samuel, Sir
Otis, Harrison Gray, Mrs	Otis, Harrison Gray	Otis, Harrison Gray, Mrs
Shioya, Sakae	Shioya, Sakae. [from old catalog]	Shioya, Sakae
Short, Raymond W. (Raymond Wright)	Short, Raymond W. (Raymond Wright)	Short, Raymond W (Raymond Wright)
Sherwood, (Mary Martha), 1775-1851, Mrs	Sherwood, Mary Martha	Sherwood, (Mary Martha), 1775-1851, Mrs	Sherwood, (Mary Martha), Mrs
Shedd, George C. (George Clifford)	Shedd, George C	Shedd, George C. (George Clifford)
Shute, Henry A. (Henry Augustus)	Shute, Henry A. (Henry Augustus)	Shute, Henry A (Henry Augustus)	Shute, Henry A
Shorthouse, J. H. (Joseph Henry)	Shorthouse, J.H	Shorthouse, J. H. (Joseph Henry)	Shorthouse, J. H	Shorthouse, J. H (Joseph Henry)
Shaw, Edward R (Edward Richard)	Shaw, Edward R (Edward Richard)	Shaw, Edward R
Shafer, Sara Andrew, Mrs	Shafer, Sara Andrew	Shafer, Sara Andrew, Mrs
Shoemaker, Henry W. (Henry Wharton)	Shoemaker, Henry W	Shoemaker, Henry W (Henry Wharton)	Shoemaker, Henry W. (Henry Wharton)
Sharber, Kate Trimble, Mrs	Sharber, Kate Trimble, Mrs	Sharber, Kate Trimble
Shillaber, B. P. (Benjamin Penhallow)	Shillaber, B. P. (Benjamin Penhallow)	Shillaber, B. P
Shiel, M. P. (Matthew Phipps)	Shiel, M. P. (Matthew Phipps)	Shiel, M. P (Matthew Phipps)	Shiel, M. P
Shepherd, William G. (William Gunn)	Shepherd, William G. (William Gunn)	Shepherd, William G
Shelton, F. W. (Frederick William)	Shelton, F. W. (Frederick William)	Shelton, F. W
Shawmeker, Harvey	Shawmeker, Harvey	Shawmeker, Harvey. [from old catalog]
Sheldon, Georgie, Mrs	Sheldon, Georgie	Sheldon, Georgie, Mrs
Sherwood, M. E. W. (Mary Elizabeth Wilson)	Sherwood, M. E. W	Sherwood, M. E. W. (Mary Elizabeth Wilson)
Shriner, Charles A. (Charles Anthony)	Shriner, Charles A. (Charles Anthony)	Shriner, Charles A
Shoemaker, Charles C. (Charles Chalmers)	Shoemaker, Charles C. (Charles Chalmers)	Shoemaker, Charles C
Sheringham, H. T. (Hugh Tempest)	Sheringham, H. T	Sheringham, H. T. (Hugh Tempest)
Shishkov, V. I͡A. (Vi͡acheslav I͡Akovlevich)	Shishkov, V. I͡A (Vi͡acheslav I͡Akovlevich)	Shishkov, V. I͡A. (Vi͡acheslav I͡Akovlevich)
Sherriff, R. C. (Robert Cedric)	Sherriff, R. C. (Robert Cedric)	Sherriff, R. C (Robert Cedric)
Abell, Lucia Elizabeth (Balcombe), Mrs	Abell, Lucia Elizabeth Balcombe	Abell, Lucia Elizabeth (Balcombe), Mrs
Abbott, Mary Perkins (Ives), Mrs	Abbott, Mary Perkins (Ives)	Abbott, Mary Perkins Ives	Abbott, Mary Perkins (Ives), Mrs
Dwight, H. G. (Harrison Griswold)	Dwight, H. G. (Harrison Griswold)	Dwight, H. G
Elson, William H. (William Harris)	Elson, William H	Elson, William H. (William Harris)
Ellis, J. Breckenridge (John Breckenridge)	Ellis, J. Breckenridge (John Breckenridge)	Ellis, J. Breckenridge
Elliott, Lizzie P. (Lizzie Porterfield)	Elliott, Lizzie P	Elliott, Lizzie P. (Lizzie Porterfield)
Elliot, Samuel H. (Samuel Hayes)	Elliot, Samuel H. (Samuel Hayes)	Elliot, Samuel H
Ellwanger, George H. (George Herman)	Ellwanger, George H. (George Herman)	Ellwanger, George H
Kuprin, A. I. (Aleksandr Ivanovich)	Kuprin, A. I (Aleksandr Ivanovich)	Kuprin, A. I. (Aleksandr Ivanovich)	Kuprin, A. I
Kuncewiczowa, Maria Szczepańska	Kuncewiczowa, Maria Szczepańska	Kuncewiczowa, Maria Szczepańska
Kuzmin, M. A. (Mikhail Alekseevich)	Kuzmin, M. A. (Mikhail Alekseevich)	Kuzmin, M. A (Mikhail Alekseevich)
Paull, H. B, Mrs	Paull, H. B, Mrs	Paull, H. B
Paull, Minnie E. (Kenney)	Paull, Minnie E. Kenney	Paull, Minnie E. (Kenney)
Paternoster, G. Sidney (George Sidney)	Paternoster, G. Sidney	Paternoster, G. Sidney (George Sidney)
Patch, Edith M. (Edith Marion)	Patch, Edith M	Patch, Edith M. (Edith Marion)
Pattillo, T. R.	Pattillo, T R	Pattillo, T. R
Parmenter, Christine (Whiting), Mrs	Parmenter, Christine (Whiting) Mrs	Parmenter, Christine Whiting	Parmenter, Christine (Whiting), Mrs
Parker, Gilbert, Sir	Parker, Gilbert	Parker, Gilbert, Sir
Pakington, Humphrey, baron Hampton	Pakington, Humphrey, Hon	Pakington, Humphrey, baron Hampton
Packard, Frank L. (Frank Lucius)	Packard, Frank L. (Frank Lucius)	Packard, Frank L
Paoli, Xavier	Paoli Xavier	Paoli, Xavier
Palangyo, Peter K. (Peter Kishili)	Palangyo, Peter K. (Peter Kishili)	Palangyo, Peter K
Paterson, A. B. (Andrew Barton)	Paterson, A. B. (Andrew Barton)	Paterson, A. B
Patterson, J. H. (John Henry)	Patterson, J. H. (John Henry)	Patterson, J. H
Packard, E. P. W. (Elizabeth Parsons Ware)	Packard, E. P. W	Packard, E. P. W. (Elizabeth Parsons Ware)
Patton, Carl S. (Carl Safford)	Patton, Carl S. (Carl Safford)	Patton, Carl S (Carl Safford)
Paton, Margaret (Whitecross)	Paton, Margaret (Whitecross)	Paton, Margaret Whitecross
Patterson, J. E. (John Edward)	Patterson, J. E	Patterson, J. E. (John Edward)
Paddock, A. G, Mrs	Paddock, A. G	Paddock, A. G, Mrs
Khosla, G. D. (Gopal Das)	Khosla, G. D (Gopal Das)	Khosla, G. D. (Gopal Das)
L. E. L. (Letitia Elizabeth Landon)	L. E. L. (Letitia Elizabeth Landon)	L. E. L (Letitia Elizabeth Landon)
Urbino, L. B. (Levina Buoncuore)	Urbino, L. B. (Levina Buoncuore)	Urbino, L. B
Jameson, Annie Edith Foster], Mrs	[Jameson, Annie Edith Foster, Mrs	[Jameson, Annie Edith Foster], Mrs	[Jameson, Annie Edith Foster
Burgess, Thornton W. (Thornton Waldo)	Burgess, Thornton W. (Thornton Waldo	Burgess, Thornton W. (Thornton Waldo)	Burgess, Thornton W
Burnand, F. C. (Francis Cowley), Sir	Burnand, F. C	Burnand, F. C. (Francis Cowley)	Burnand, F. C. (Francis Cowley), Sir
Buck, Pearl S. (Pearl Sydenstricker)	Buck, Pearl S. (Pearl Sydenstricker)	Buck, Pearl S (Pearl Sydenstricker)
Burrows, E, Mrs	Burrows, E, Mrs	Burrows, E
Burke, T. A. (Thomas A.)	Burke, T. A. (Thomas A.)	Burke, T. A
Buckmaster, Henrietta, pseud	Buckmaster, Henrietta, pseud	Buckmaster, Henrietta
Burnett, Frances (Hodgson)	Burnett, Frances (Hodgson)	Burnett, Frances Hodgson
Bury, Charlotte Campbell, Lady	Bury, Charlotte Campbell	Bury, Charlotte Campbell, Lady
Buckley, William F. (William Frank)	Buckley, William F. (William Frank)	Buckley, William F (William Frank)
Burdett, C. D, Mrs	Burdett, C. D	Burdett, C. D, Mrs
Burgin, G. B. (George Brown)	Burgin, G. B. (George Brown)	Burgin, G. B
Bunner, H. C. (Henry Cuyler)	Bunner, H. C	Bunner, H. C. (Henry Cuyler)
Butler, William Francis, Sir	Butler, William Francis, Sir	Butler, William Francis
Burdette, Robert J. (Robert Jones)	Burdette, Robert J. (Robert Jones)	Burdette, Robert J
Austin, F. Britten (Frederick Britten)	Austin, F. Britten (Frederick Britten)	Austin, F. Britten
Austin, Jane G. (Jane Goodwin)	Austin, Jane G. (Jane Goodwin)	Austin, Jane G
Pieyre de Mandiargues, André	Pieyre de Mandiargues, André	Pieyre de Mandiargues, André
Pierce, Ruth, Mrs	Pierce, Ruth, Mrs	Pierce, Ruth
Pierce, Gilbert A. (Gilbert Ashville)	Pierce, Gilbert A	Pierce, Gilbert A. (Gilbert Ashville)
Pinkerton, Kathrene Sutherland (Gedney)	Pinkerton, Kathrene Sutherland Gedney	Pinkerton, Kathrene Sutherland (Gedney)
Pisemskiĭ, A. F. (Alekseĭ Feofilaktovich)	Pisemskiĭ, A. F (Alekseĭ Feofilaktovich)	Pisemskiĭ, A. F. (Alekseĭ Feofilaktovich)
Crandall, Lathan A. (Lathan Augustus)	Crandall, Lathan A	Crandall, Lathan A. (Lathan Augustus)
Crake, A. D. (Augustine David)	Crake, A. D	Crake, A. D. (Augustine David)
Creyke, Walter, Mrs	Creyke, Walter	Creyke, Walter, Mrs
Crumpton, H. J. (Hezekiah John)	Crumpton, H. J	Crumpton, H. J. (Hezekiah John)
Craik, Dinah Maria (Mulock), Mrs	Craik, Dinah Maria Mulock	Craik, Dinah Maria (Mulock), Mrs
Crawford, F. Marion (Francis Marion)	Crawford, F. Marion (Francis Marion)	Crawford, F. Marion
Crosland, Newton, Mrs	Crosland, Newton, Mrs	Crosland, Newton
Crockett, S. R. (Samuel Rutherford)	Crockett, S. R. (Samuel Rutherford)	Crockett, S. R
Croker, B. M. (Bithia Mary)	Croker, B. M	Croker, B. M. (Bithia Mary)
Cronin, A. J. (Archibald Joseph)	Cronin, A. J. (Archibald Joseph)	Cronin, A. J (Archibald Joseph)
Crowninshield, Schuyler, Mrs	Crowninshield, Schuyler, Mrs	Crowninshield, Schuyler
Craik, Georgiana M. (Georgiana Marion)	Craik, Georgiana M. (Georgiana Marion)	Craik, Georgiana M
Cruz, Roman A. de la	Cruz, Roman A de la	Cruz, Roman A. de la
Crawford, Lucy, Mrs	Crawford, Lucy, Mrs	Crawford, Lucy
Crawford, M. MacDermot (Mary MacDermot)	Crawford, M. MacDermot	Crawford, M. MacDermot (Mary MacDermot)
Musick, John R. (John Roy)	Musick, John R. (John Roy)	Musick, John R (John Roy)	Musick, John R
Muse, Benjamin	Muse, Benjamin. [from old catalog]	Muse, Benjamin
Murray, W. H. H. (William Henry Harrison)	Murray, W. H. H	Murray, W. H. H. (William Henry Harrison)
Muddock, J. E. (Joyce Emmerson Preston)	Muddock, J. E. (Joyce Emmerson Preston)	Muddock, J. E. (Joyce Emmerson)
Murray, Charles Augustus, Sir	Murray, Charles Augustus, Sir	Murray, Charles Augustus
Quincy, Samuel M. (Samuel Miller)	Quincy, Samuel M	Quincy, Samuel M. (Samuel Miller)
Quiller-Couch, Arthur Thomas, Sir	Quiller-Couch, Arthur Thomas, Sir	Quiller-Couch, Arthur Thomas	Quiller-Couch, Arthur
Nyburg, Sidney L. (Sidney Lauer)	Nyburg, Sidney L	Nyburg, Sidney L. (Sidney Lauer)
Sullivan, May Kellogg, Mrs	Sullivan, May Kellogg, Mrs	Sullivan, May Kellogg
Summers, Florence Elizabeth	Summers, Florence Elizabeth	Summers, Florence Elizabeth. [from old catalog]
Sulzberger, C. L. (Cyrus Leo)	Sulzberger, C. L. (Cyrus Leo)	Sulzberger, C. L (Cyrus Leo)
Vaizey, George de Horne, Mrs	Vaizey, George de Horne, Mrs	Vaizey, George de Horne
Van Dyke, Theodore S. (Theodore Strong)	Van Dyke, Theodore S	Van Dyke, Theodore S. (Theodore Strong)
Van Zile, Edward S. (Edward Sims)	Van Zile, Edward S. (Edward Sims)	Van Zile, Edward S
Van den Heever, C. M. (Christiaan Maurits)	Van den Heever, C. M. (Christiaan Maurits)	Van den Heever, C. M (Christiaan Maurits)
Van de Water, Virginia Belle (Terhune)	Van de Water, Virginia Belle (Terhune)	Van de Water, Virginia Terhune
Van Vogt, A. E. (Alfred Elton)	Van Vogt, A. E (Alfred Elton)	Van Vogt, A. E. (Alfred Elton)
Vandercook, John W. (John Womack)	Vandercook, John W (John Womack)	Vandercook, John W. (John Womack)
Kingsley, Florence (Morse), Mrs	Kingsley, Florence Morse, Mrs	Kingsley, Florence Morse	Kingsley, Florence (Morse), Mrs	Kingsley, Florence (Morse)
Kirkland, Caroline M. (Caroline Matilda)	Kirkland, Caroline M	Kirkland, Caroline M. (Caroline Matilda)	Kirkland, Caroline M (Caroline Matilda)
Kimball, Richard B. (Richard Burleigh)	Kimball, Richard B	Kimball, Richard B. (Richard Burleigh)
Kinzie, John H., Mrs	Kinzie, John H, Mrs	Kinzie, John H	Kinzie, John H., Mrs
Kincaid, C. A. (Charles Augustus)	Kincaid, C. A. (Charles Augustus)	Kincaid, C. A
Kimball, James Newton	Kimball, James Newton. [from old catalog]	Kimball, James Newton
Kinkaid, Mary Holland (McNeish), Mrs	Kinkaid, Mary Holland McNeish	Kinkaid, Mary Holland (McNeish), Mrs
Plaatje, Sol. T. (Solomon Tshekisho)	Plaatje, Sol. T (Solomon Tshekisho)	Plaatje, Sol. T. (Solomon Tshekisho)
Plympton, A. G. (Almira George)	Plympton, A. G	Plympton, A. G. (Almira George)
Ilsley, Charles P. (Charles Parker)	Ilsley, Charles P. (Charles Parker)	Ilsley, Charles P
Kaberlein, Joseph J. (Joseph James)	Kaberlein, Joseph J. (Joseph James)	Kaberlein, Joseph J (Joseph James)
Kaverin, V. (Veniamin)	Kaverin, V. (Veniamin)	Kaverin, V (Veniamin)
Jefferson, Robert L. (Robert Louis)	Jefferson, Robert L	Jefferson, Robert L. (Robert Louis)
Jelliffe, Belinda Dobson, Mrs	Jelliffe, Belinda Dobson, Mrs	Jelliffe, Belinda Dobson
Jensen, Johannes V. (Johannes Vilhelm)	Jensen, Johannes V (Johannes Vilhelm)	Jensen, Johannes V. (Johannes Vilhelm)
Jennings, John A. (John Andrew)	Jennings, John A. (John Andrew)	Jennings, John A
Jerome, Jerome K. (Jerome Klapka)	Jerome, Jerome K (Jerome Klapka)	Jerome, Jerome K. (Jerome Klapka)	Jerome, Jerome K
Jenkin, C. (Camilla)	Jenkin, C	Jenkin, C, Mrs	Jenkin, C. (Camilla)
Jesse, F. Tennyson (Fryniwyd Tennyson)	Jesse, F. Tennyson (Fryniwyd Tennyson)	Jesse, F. Tennyson
Campbell, J. F. (John Francis)	Campbell, J. F	Campbell, J. F. (John Francis)
Campbell, Juliet H. L. (Juliet Hamersley Lewis)	Campbell, Juliet H. L. (Juliet Hamersley Lewis)	Campbell, Juliet H. L
Castle, Agnes (Sweetman), Mrs	Castle, Agnes (Sweetman)	Castle, Agnes (Sweetman), Mrs
Carr, J. L. (Joseph Lloyd)	Carr, J. L. (James Lloyd)	Carr, J. L. (Joseph Lloyd)
Cabrera Infante, G. (Guillermo)	Cabrera Infante, G. (Guillermo)	Cabrera Infante, G (Guillermo)
Caffyn, Kathleen Mannington (Hunt)	Caffyn, Kathleen Mannington Hunt	Caffyn, Kathleen Mannington (Hunt)
Cain, James M. (James Mallahan)	Cain, James M (James Mallahan)	Cain, James M. (James Mallahan)
Carter, William H (William Harding)	Carter, William H	Carter, William H (William Harding)
Calkins, Frank W. (Frank Welles)	Calkins, Frank W. (Frank Welles)	Calkins, Frank W
Cassill, R. V. (Ronald Verlin)	Cassill, R. V (Ronald Verlin)	Cassill, R. V. (Ronald Verlin)
Castle, William R. (William Richards)	Castle, William R. (William Richards)	Castle, William R
Carlsen, C. L. (Carl Laurence)	Carlsen, C. L. (Carl Laurence)	Carlsen, C. L
Caine, Hall, Sir	Caine, Hall, Sir	Caine, Hall
Campbell, C. G. (Charles Grimshaw)	Campbell, C. G. (Charles Grimshaw)	Campbell, C. G (Charles Grimshaw)
Oppenheim, E. Phillips (Edward Phillips)	Oppenheim, E. Phillips (Edward Phillips)	Oppenheim, E. Phillips
Anderdon, W. H. (William Henry)	Anderdon, W. H. (William Henry)	Anderdon, W. H (William Henry)
Andrews, Mary Raymond (Shipman), Mrs	Andrews, Mary Raymond (Shipman)	Andrews, Mary Raymond (Shipman), Mrs
Andress, J. Mace (James Mace)	Andress, J. Mace	Andress, J. Mace (James Mace)
Andersen, H. C. (Hans Christian)	Andersen, H. C. (Hans Christian)	Andersen, H. C	Andersen, H. C (Hans Christian)
Anderson, A. J. (Arthur James)	Anderson, A. J. (Arthur James)	Anderson, A. J
Andrēasean, A. (Andranik)	Andrēasean, A (Andranik)	Andrēasean, A. (Andranik)
Russell, William Howard, Sir	Russell, William Howard, Sir	Russell, William Howard
Rucker, Rudy v. B. (Rudy von Bitter)	Rucker, Rudy v. B (Rudy von Bitter)	Rucker, Rudy v. B. (Rudy von Bitter)
Reynolds, Baillie, Mrs	Reynolds, Baillie	Reynolds, Baillie, Mrs
Reeve, F. D. (Franklin D.)	Reeve, F. D. (Franklin D.)	Reeve, F. D (Franklin D.)
Reynolds, George W. M. (George William MacArthur)	Reynolds, George W. M. (George William MacArthur)	Reynolds, George W. M
Reed, Earl H. (Earl Howell)	Reed, Earl H	Reed, Earl H. (Earl Howell)
Reynolds, E. W. (Elhanan Winchester)	Reynolds, E. W	Reynolds, E. W. (Elhanan Winchester)
Reed, A. W. (Alexander Wyclif)	Reed, A. W (Alexander Wyclif)	Reed, A. W. (Alexander Wyclif)
Reeve, Arthur B. (Arthur Benjamin)	Reeve, Arthur B	Reeve, Arthur B. (Arthur Benjamin)
Rees, Arthur J. (Arthur John)	Rees, Arthur J. (Arthur John)	Rees, Arthur J
Reeves, Ira L. (Ira Louis)	Reeves, Ira L. (Ira Louis)	Reeves, Ira L
Chamot, A. E. (Alfred Edward)	Chamot, A. E (Alfred Edward)	Chamot, A. E. (Alfred Edward)
Chase, Amanda (Mathews), Mrs	Chase, Amanda (Mathews)	Chase, Amanda (Mathews), Mrs
Chambers, Robert W. (Robert William)	Chambers, Robert W. (Robert William)	Chambers, Robert W
Cheley, F. H. (Frank Hobart)	Cheley, F. H	Cheley, F. H. (Frank Hobart)
Champney, Elizabeth W. (Elizabeth Williams)	Champney, Elizabeth (Williams), Mrs	Champney, Elizabeth W	Champney, Elizabeth W. (Elizabeth Williams)	Champney, Elizabeth Williams
Chesterton, G. K. (Gilbert Keith)	Chesterton, G. K	Chesterton, G. K. (Gilbert Keith)	Chesterton, G. K (Gilbert Keith)
Chisholm, A. M. (Arthur Murray)	Chisholm, A. M	Chisholm, A. M. (Arthur Murray)
Chesnutt, Charles W. (Charles Waddell)	Chesnutt, Charles W. (Charles Waddell)	Chesnutt, Charles W (Charles Waddell)	Chesnutt, Charles W
Chase, Margaret Hatfield, Mrs	Chase, Margaret Hatfield	Chase, Margaret Hatfield, Mrs
Chesney, George Tomkyns, Sir	Chesney, George Tomkyns	Chesney, George Tomkyns, Sir
Channon, E. M. (Ethel Mary)	Channon, E. M. (Ethel Mary)	Channon, E. M
Challice, Annie Emma (Armstrong), Mrs	Challice, Annie Emma (Armstrong)	Challice, Annie Emma (Armstrong), Mrs
Churchill, Winston, Sir	Churchill, Winston	Churchill, Winston, Sir
Chetwood, W. R. (William Rufus)	Chetwood, W. R	Chetwood, W. R. (William Rufus)	Chetwood, W. R (William Rufus)
Chase, J. Smeaton (Joseph Smeaton)	Chase, J. Smeaton (Joseph Smeaton)	Chase, J. Smeaton
Chatfield-Taylor, H. C. (Hobart Chatfield)	Chatfield-Taylor, H. C	Chatfield-Taylor, H. C. (Hobart Chatfield)
Chase, Eliza B. (Eliza Brown)	Chase, Eliza B	Chase, Eliza B. (Eliza Brown)
Chamberlain, N. H. (Nathan Henry)	Chamberlain, N. H	Chamberlain, N. H. (Nathan Henry)
Champney, Elizabeth (Williams), Mrs	Champney, Elizabeth (Williams), Mrs	Champney, Elizabeth (Williams)
Child, (Lydia Maria), Mrs	Child, (Lydia Maria), Mrs	Child, Lydia Maria
Christensen, Lars Saabye	Christensen, Lars Saabye	Christensen, Lars Saaybe
Chatterton, Georgiana, Lady	Chatterton, Georgiana, Lady	Chatterton, Georgiana
Chappell, George S. (George Shepard)	Chappell, George S	Chappell, George S. (George Shepard)
Jaques, E. T. (Edward Tyrrell)	Jaques, E. T	Jaques, E. T. (Edward Tyrrell)
Jamison, C. V. (Cecilia Viets)	Jamison, C. V. (Cecilia Viets)	Jamison, C. V
Jacobs, W. W. (William Wymark)	Jacobs, W. W (William Wymark)	Jacobs, W.W	Jacobs, W. W	Jacobs, W. W. (William Wymark)
James, G. P. R. (George Payne Rainsford)	James, G. P. R. (George Payne Rainsford)	James, G. P. R
James, C. L. R. (Cyril Lionel Robert)	James, C. L. R (Cyril Lionel Robert)	James, C. L. R. (Cyril Lionel Robert)
Jagendorf, M. A. (Moritz Adolph)	Jagendorf, M. A (Moritz Adolph)	Jagendorf, M. A. (Moritz Adolph)
Jacobsen, J. P. (Jens Peter)	Jacobsen, J. P	Jacobsen, J. P (Jens Peter)	Jacobsen, J. P. (Jens Peter)
James, M. R. (Montague Rhodes)	James, M. R	James, M. R. (Montague Rhodes)
Jackson, Gabrielle Emilie Snow, Mrs	Jackson, Gabrielle Emilie Snow	Jackson, Gabrielle Emilie Snow, Mrs
Janvier, Thomas A. (Thomas Allibone)	Janvier, Thomas A	Janvier, Thomas A. (Thomas Allibone)
Jacks, L. P. (Lawrence Pearsall)	Jacks, L. P	Jacks, L. P. (Lawrence Pearsall)
Dunlop, Madeline Anne Wallace-	Dunlop, Madeline Anne Wallace-	Dunlop, Madeline Anne Wallace
Du Bois, W. E. B. (William Edward Burghardt)	Du Bois, W. E. B. (William Edward Burghardt)	Du Bois, W. E. B (William Edward Burghardt)
Du Chaillu, Paul B. (Paul Belloni)	Du Chaillu, Paul B. (Paul Belloni)	Du Chaillu, Paul B
Dunn, Byron A. (Byron Archibald)	Dunn, Byron A	Dunn, Byron A. (Byron Archibald)
Dupuy, Eliza A. (Eliza Ann)	Dupuy, Eliza A	Dupuy, Eliza A. (Eliza Ann)
Dunsany, Edward John Moreton Drax Plunkett, Baron	Dunsany, Edward John Moreton Drax Plunkett	Dunsany, Edward John Moreton Drax Plunkett, Baron
Du Boisgobey, Fortuné	Du Boisgobey, Fortune	Du Boisgobey, Fortuné
Hare, Augustus J. C. (Augustus John Cuthbert)	Hare, Augustus J. C	Hare, Augustus J. C. (Augustus John Cuthbert)
Harney, W. E. (William Edward)	Harney, W. E (William Edward)	Harney, W. E. (William Edward)
Hart, Frances (Noyes), Mrs	Hart, Frances Noyes	Hart, Frances (Noyes), Mrs
Hammond, S. H. (Samuel H.)	Hammond, S. H. (Samuel H.)	Hammond, S. H
Harben, Will N. (William Nathaniel)	Harben, Will N. (Will Nathaniel)	Harben, Will N	Harben, Will N. (William Nathaniel)
Harker, L. Allen (Lizzie Allen), Mrs	Harker, L. Allen	Harker, L. Allen (Lizzie Allen)	Harker, L. Allen (Lizzie Allen), Mrs
Harrison, Burton, Mrs	Harrison, Burton, Mrs	Harrison, Burton
Hayes, Clair W. (Clair Wallace)	Hayes, Clair W	Hayes, Clair W. (Clair Wallace)
Hales, A. G. (Alfred Greenwood)	Hales, A. G. (Alfred Greenwood)	Hales, A. G
Hall, S. C., Mrs	Hall, S. C, Mrs	Hall, S. C	Hall, S. C., Mrs
Haviland, Laura S. (Laura Smith)	Haviland, Laura S. (Laura Smith)	Haviland, Laura S (Laura Smith)
Harding, John W. (John William)	Harding, John W. (John William)	Harding, John W
Haviland, Maud D. (Maud Doria)	Haviland, Maud D	Haviland, Maud D. (Maud Doria)
Hassaurek, F. (Friedrich)	Hassaurek, F	Hassaurek, F. (Friedrich)
Haldeman-Julius, E. (Emanuel)	Haldeman-Julius, E	Haldeman-Julius, E. (Emanuel)
Haven, Alice B. (Alice Bradley)	Haven, Alice B	Haven, Alice B. (Alice Bradley)
Haggard, H. Rider (Henry Rider)	Haggard, H. Rider (Henry Rider)	Haggard, H. Rider
Hayes, I. I. (Isaac Israel)	Hayes, I. I. (Isaac Israel)	Hayes, I. I
Harman, Michael Garber	Harman, Michael Garber. [from old catalog]	Harman, Michael Garber
Hamley, W. G. (William George)	Hamley, W. G. (William George)	Hamley, W. G
Hall, Angus W, Mrs	Hall, Angus W, Mrs	Hall, Angus W
Hamilton, J. (John)	Hamilton, J	Hamilton, J. (John)
Hale, Lucretia P. (Lucretia Peabody)	Hale, Lucretia P. (Lucretia Peabody)	Hale, Lucretia P	Hale, Lucretia P (Lucretia Peabody)
Haig-Brown, Roderick Langmere	Haig-Brown, Roderick Langmere	Haig-Brown, Roderick L
Hancock, H. Irving (Harrie Irving)	Hancock, H. Irving	Hancock, H. Irving (Harrie Irving)
Hamley, Edward Bruce, Sir	Hamley, Edward Bruce	Hamley, Edward Bruce, Sir
Hamill, Katherine B. (Katherine Bernie)	Hamill, Katherine B	Hamill, Katherine B. (Katherine Bernie)
Guthrie, A. B. (Alfred Bertram)	Guthrie, A. B. (Alfred Bertram)	Guthrie, A. B (Alfred Bertram)
Gunning, (Susannah), Mrs	Gunning, (Susannah), Mrs	Gunning, Mrs. (Susannah)
Gurney, A. R. (Albert Ramsdell)	Gurney, A. R (Albert Ramsdell)	Gurney, A. R. (Albert Ramsdell)
Guest, Edgar A. (Edgar Albert)	Guest, Edgar A. (Edgar Albert)	Guest, Edgar A	Guest, Edgar A (Edgar Albert)
Guerber, H. A. (Hélène Adeline)	Guerber, H. A	Guerber, H. A. (Hélène Adeline)
Guérard, Albert J. (Albert Joseph)	Guérard, Albert J. (Albert Joseph)	Guérard, Albert J (Albert Joseph)
Gusev-Orenburgskiĭ, S. I. (Sergeĭ Ivanovich)	Gusev-Orenburgskiĭ, S. I. (Sergeĭ Ivanovich)	Gusev-Orenburgskiĭ, S. I (Sergeĭ Ivanovich)
Uttley, Alison, Mrs	Uttley, Alison	Uttley, Alison, Mrs
Maugham, W. Somerset, (William Somerset)	Maugham, W. Somerset (William Somerset)	Maugham, W. Somerset	Maugham, W. Somerset, (William Somerset)
Malory, Thomas, Sir	Malory, Thomas	Malory, Thomas, Sir
Marquand, John P. (John Phillips)	Marquand, John P	Marquand, John P. (John Phillips)	Marquand, John P (John Phillips)
Macquoid, Katharine Sarah (Gadsden), Mrs	Macquoid, Katharine Sarah (Gadsden), Mrs	Macquoid, Katharine S. (Katharine Sarah)
Mason, Catherine George (Ward), Mrs	Mason, Catherine George (Ward)	Mason, Catherine George (Ward), Mrs
Mallock, W. H. (William Hurrell)	Mallock, W. H. (William Hurrell)	Mallock, W. H	Mallock, W. H (William Hurrell)
Manners-Sutton, D. (Doris)	Manners-Sutton, D	Manners-Sutton, D. (Doris)
Marlitt, E. (Eugenie)	Marlitt, E. (Eugenie)	Marlitt, E (Eugenie)	Marlitt, E
Mackay, Helen, Mrs	Mackay, Helen	Mackay, Helen, Mrs
Mackay, Isabel Ecclestone (Macpherson), Mrs	Mackay, Isabel Ecclestone (Macpherson)	Mackay, Isabel Ecclestone (Macpherson), Mrs	Mackay, Isabel Ecclestone
Maxwell, Ellen (Blackmar)	Maxwell, Ellen (Blackmar)	Maxwell, Ellen Blackmar
Mayo, Isabella (Fyvie)	Mayo, Isabella Fyvie	Mayo, Isabella (Fyvie)
Maxwell, W. H. (William Hamilton)	Maxwell, W. H	Maxwell, W. H. (William Hamilton)
Martin, George (Madden), Mrs	Martin, George Madden	Martin, George (Madden), Mrs	Martin, George (Madden)
Mason, Catherine George Ward, Mrs	Mason, Catherine George Ward	Mason, Catherine George Ward, Mrs
Maxwell, Mary Elizabeth (Braddon), Mrs	Maxwell, Mary Elizabeth (Braddon), Mrs	Maxwell, Mary Elizabeth (Braddon)
Markham, Clements R. (Clements Robert), Sir	Markham, Clements R. (Clements Robert), Sir	Markham, Clements R
Mackenzie, Compton, Sir	Mackenzie, Compton	Mackenzie, Compton, Sir
Macdonnell, J. E. (James Edmond)	Macdonnell, J. E. (James Edmond)	Macdonnell, J. E (James Edmond)
Malcolm, John, Sir	Malcolm, John, Sir	Malcolm, John
Mason, Benjamin F. (Benjamin Franklin)	Mason, Benjamin F	Mason, Benjamin F. (Benjamin Franklin)
Manhood, H. A. (Harold Alfred)	Manhood, H. A. (Harold Alfred)	Manhood, H. A (Harold Alfred)
Margueritte, V. (Victor)	Margueritte, V. (Victor)	Margueritte, V
Mackenzie, R. Shelton (Robert Shelton)	Mackenzie, R. Shelton (Robert Shelton)	Mackenzie, R. Shelton
Mann, Mary E., (Rackham) | Mrs	Mann, Mary E., (Rackham)	Mann, Mary E., (Rackham) | Mrs
Mason, A. E. W. (Alfred Edward Woodley)	Mason, A. E. W. (Alfred Edward Woodley)	Mason, A. E. W
Macchetta, Blanche Roosevelt Tucker, Mrs	Macchetta, Blanche Roosevelt Tucker, Mrs	Macchetta, Blanche Roosevelt Tucker
Marvel, Ik	Marvel, Ik	Marvel Ik
Matthews, Caroline Twigge, Mrs	Matthews, Caroline Twigge, Mrs	Matthews, Caroline Twigge
Marsh, H. P (Horace Pierce)	Marsh, H. P	Marsh, H. P (Horace Pierce)
Marshall, S. L. A. (Samuel Lyman Atwood)	Marshall, S. L. A. (Samuel Lyman Atwood)	Marshall, S. L. A (Samuel Lyman Atwood)
Marchmont, Arthur W. (Arthur Williams)	Marchmont, Arthur W	Marchmont, Arthur W. (Arthur Williams)
Manley, (Mary de la Rivière), Mrs	Manley, Mrs. (Mary de la Rivière)	Manley, (Mary de la Rivière), Mrs	Manley, (Mary de la Rivière), Mrs
Marshall, Emma, Mrs	Marshall, Emma, Mrs	Marshall, Emma
Madame de La Fayette, (Marie-Madeleine Pioche de La Vergne)	Madame de La Fayette, (Marie-Madeleine Pioche de La Vergne)	Madame de (Marie-Madeleine Pioche de La Vergne), La Fayette
Mayor, F. M. (Flora Macdonald)	Mayor, F. M	Mayor, F. M. (Flora Macdonald)
Madame d' (Marie-Catherine), Aulnoy	Madame d' (Marie-Catherine), Aulnoy	Madame d' Aulnoy, (Marie-Catherine)
Mason, Caroline (Atwater)	Mason, Caroline Atwater	Mason, Caroline (Atwater)
MacGregor, Mary Esther (Millier), Mrs	MacGregor, Mary Esther Miller	MacGregor, Mary Esther (Millier), Mrs
Mackail, J. W. (John William)	Mackail, J. W	Mackail, J. W. (John William)	Mackail, J. W (John William)
Macnaughtan, S. (Sarah)	Macnaughtan, S	Macnaughtan, S. (Sarah)
Mannix, Daniel P. (Daniel Pratt)	Mannix, Daniel P. (Daniel Pratt)	Mannix, Daniel P (Daniel Pratt)
Maxwell, W. B. (William Babington)	Maxwell, W. B. (William Babington)	Maxwell, W. B
Mackenzie, Donald A. (Donald Alexander)	Mackenzie, Donald A. (Donald Alexander)	Mackenzie, Donald A (Donald Alexander)
Major (John), Richardson	Major (John), Richardson	Major Richardson, (John)
Martin du Gard, Roger	Martin du Gard, Roger	Martin Du Gard, Roger
Matz, B. W. (Bertram Waldrom)	Matz, B. W. (Bertram Waldrom)	Matz, B. W
Martin, Frank E. (Frank Eugene)	Martin, Frank E	Martin, Frank E. (Frank Eugene)
Balfour, Andrew, Sir	Balfour, Andrew, Sir	Balfour, Andrew
Bazhov, P. P. (Pavel Petrovich)	Bazhov, P. P (Pavel Petrovich)	Bazhov, P. P. (Pavel Petrovich)
Ballantyne, R. M. (Robert Michael)	Ballantyne, R. M. (Robert Michael)	Ballantyne, R. M	Ballantyne, R. M (Robert Michael)
Babelʹ, I. (Isaak)	Babelʹ, I (Isaak)	Babelʹ, I. (Isaak)
Barnes, Josiah	Barnes, Josiah	Barnes, Josiah. [from old catalog]
Barton, William Eleazar, 1861-1930	Barton, William Eleazar, 1861-1930	Barton, William Eleazar
Barrett, William E.   (William Edmund)	Barrett, William E.   (William Edmund)	Barrett, William E. (William Edmund)	Barrett, William E (William Edmund)
Barbour, A. Maynard (Anna Maynard)	Barbour, A. Maynard	Barbour, A. Maynard (Anna Maynard)
Bayly, (Mary), Mrs	Bayly, Mary	Bayly, (Mary), Mrs
Bacon, Mrs. Albion Fellows	Bacon, Mrs. Albion Fellows	Bacon, Albion Fellows, Mrs
Bailey, H. C. (Henry Christopher)	Bailey, H. C. (Henry Christopher)	Bailey, H. C
Banerjea, S. B.	Banerjea, S. B	Banerjea, S.B
Baum, L. Frank (Lyman Frank)	Baum, L. Frank	Baum, L. Frank (Lyman Frank)
Bates, E. Katherine (Emily Katherine)	Bates, E. Katherine	Bates, E. Katherine (Emily Katherine)
Barash ,Asher	Barash ,Asher	Barash, Asher
Baker, Samuel White, Sir	Baker, Samuel White, Sir	Baker, Samuel White
Barnum, P. T. (Phineas Taylor)	Barnum, P. T. (Phineas Taylor)	Barnum, P. T
Bartley, Nalbro Isadorah, Mrs	Bartley, Nalbro Isadorah	Bartley, Nalbro Isadorah, Mrs
Bacon, Josephine Dodge (Daskam), Mrs	Bacon, Josephine Dodge (Daskam), Mrs	Bacon, Josephine Dodge Daskam	Bacon, Mrs. Josephine Dodge Daskam
Bain, F. W. (Francis William)	Bain, F. W (Francis William)	Bain, F. W. (Francis William)	Bain, F. W
Bartlett, W. C. (William Chambers)	Bartlett, W. C. (William Chambers)	Bartlett, W. C
Baldwin, Joseph G. (Joseph Glover)	Baldwin, Joseph G	Baldwin, Joseph G. (Joseph Glover)
Barclay, Florence L. (Florence Louisa)	Barclay, Florence L	Barclay, Florence L. (Florence Louisa)
Balzac, Honore   de	Balzac, Honore de	Balzac, Honore   de
Bates, H. E. (Herbert Ernest)	Bates, H. E (Herbert Ernest)	Bates, H. E. (Herbert Ernest)
Barker, A. L. (Audrey Lillian)	Barker, A. L (Audrey Lillian)	Barker, A. L. (Audrey Lillian)
Banks, G. Linnaeus (George Linnaeus), Mrs	Banks, G. Linnaeus	Banks, G. Linnaeus (George Linnaeus), Mrs
Bates, Josephine W. (Josephine White)	Bates, Josephine W	Bates, Josephine W. (Josephine White)
Barrie, J. M. (James Matthew)	Barrie, J. M. (James Matthew)	Barrie, J. M	Barrie, J. M (James Matthew)
Barnes, Will C. (Will Croft)	Barnes, Will C. (Will Croft)	Barnes, Will C
Bailey, James M. (James Montgomery)	Bailey, James M	Bailey, James M. (James Montgomery)
Barbey d'Aurevilly, J. (Jules)	Barbey d'Aurevilly, J (Jules)	Barbey d'Aurevilly, J. (Jules)
Bashford, H. H. (Henry Howarth), Sir	Bashford, H. H. (Henry Howarth), Sir	Bashford, H. H. Sir, (Henry Howarth)
Bartlett, Alice E. (Alice Elinor)	Bartlett, Alice E	Bartlett, Alice E. (Alice Elinor)
Baring-Gould, S. (Sabine)	Baring-Gould, S. (Sabine)	Baring-Gould, S
Bain, R. Nisbet (Robert Nisbet)	Bain, R. Nisbet	Bain, R. Nisbet (Robert Nisbet)
Barclay, Hubert, Mrs	Barclay, Hubert, Mrs	Barclay, Hubert
Eells, Elsie (Spicer) Mrs	Eells, Elsie (Spicer) Mrs	Eells, Elsie Spicer
Turczynowicz, Laura (Blackwell) de Gozdawa	Turczynowicz, Laura (Blackwell) de Gozdawa	Turczynowicz, Laura Blackwell de Gozdawa
Tuckerman, Henry T. (Henry Theodore)	Tuckerman, Henry T. (Henry Theodore)	Tuckerman, Henry T (Henry Theodore)
Wilder, Marshall P. (Marshall Pinckney)	Wilder, Marshall P. (Marshall Pinckney)	Wilder, Marshall P
Wilkins, Vaughan (William Vaughan)	Wilkins, Vaughan (William Vaughan)	Wilkins, William Vaughan
Witwer, H. C. (Harry Charles)	Witwer, H. C	Witwer, H. C. (Harry Charles)
Wilcox, Constance Grenelle	Wilcox, Constance Grenelle	Wilcox, Constance Grenelle. [from old catalog]
Wilkins, Louisa (Jebb)	Wilkins, Louisa Jebb	Wilkins, Louisa (Jebb)
Williamson, A. M. (Alice Muriel)	Williamson, A. M	Williamson, A. M. (Alice Muriel)
Wills, C. J. (Charles James)	Wills, C. J. (Charles James)	Wills, C. J (Charles James)
Wigram, W. Knox (William Knox)	Wigram, W. Knox (William Knox)	Wigram, W. Knox
Willcocks, M. P. (Mary Patricia)	Willcocks, M. P	Willcocks, M. P. (Mary Patricia)
Williams, John (John Edward)	Williams, John Edward	Williams, John (John Edward)
Winslow, Thyra (Samter) Mrs	Winslow, Thyra Samter	Winslow, Thyra (Samter)	Winslow, Thyra (Samter) Mrs
Williams, H. Noel (Hugh Noel)	Williams, H. Noel	Williams, H. Noel (Hugh Noel)
Willard, Frances E. (Frances Elizabeth)	Willard, Frances E. (Frances Elizabeth)	Willard, Frances E
Williams, Joel Strother	Williams, Joel Strother	Williams, Joel Strother. [from old catalog]
Williamson, C. N. (Charles Norris)	Williamson, C. N. (Charles Norris)	Williamson, C. N
Wilkins, W. H. (William Henry)	Wilkins, W. H	Wilkins, W. H. (William Henry)
Ireland, W. H. (William Henry)	Ireland, W. H. (William Henry)	Ireland, W. H
Ireland, Annie Elizabeth (Nicholson)	Ireland, Annie Elizabeth (Nicholson)	Ireland, Annie Elizabeth Nicholson
De Berard, Frederick B. (Frederick Brigham)	De Berard, Frederick Brigham	De Berard, Frederick B. (Frederick Brigham)	De Berard, Frederick B
De Kroyft, Helen (Aldrich), Mrs	De Kroyft, Helen (Aldrich)	De Kroyft, Helen Aldrich	De Kroyft, Helen (Aldrich), Mrs
De La Pasture, Henry, Mrs	De La Pasture, Henry, Mrs	De La Pasture, Henry
Deming, Therese (Osterheld), Mrs	Deming, Therese (Osterheld)	Deming, Therese (Osterheld), Mrs
Denison, Mary A. (Mary Andrews)	Denison, Mary A. (Mary Andrews)	Denison, Mary A
De Saussure, N. B. (Nancy Bostick), Mrs	De Saussure, N. B	De Saussure, N. B. (Nancy Bostick), Mrs	De Saussure, N. B. Mrs (Nancy Bostick)
Dell, Ethel M. (Ethel May)	Dell, Ethel M. (Ethel May)	Dell, Ethel M
De Leon, T. C. (Thomas Cooper)	De Leon, T. C	De Leon, T. C. (Thomas Cooper)
Putnam, Nina (Wilcox), Mrs	Putnam, Nina Wilcox	Putnam, Nina (Wilcox), Mrs	Putnam, Nina (Wilcox)
Putnam Weale, B. L. (Bertram Lenox)	Putnam Weale, B. L. (Bertram Lenox)	Putnam Weale, B. L
Pullen, H. W. (Henry William)	Pullen, H. W	Pullen, H. W. (Henry William)
Ewing, Juliana Horatia Gatty	Ewing, Juliana Horatia	Ewing, Juliana Horatia Gatty
Inglis, Henry D. (Henry David)	Inglis, Henry D. (Henry David)	Inglis, Henry D (Henry David)
Ingraham, J. H. (Joseph Holt)	Ingraham, J. H. (Joseph Holt)	Ingraham, J. H
Inchbold, A. C. (A. Cunnick)	Inchbold, A. C	Inchbold, A. C. (A. Cunnick)
Ingram, Eleanor M. (Eleanor Marie)	Ingram, Eleanor M. (Eleanor Marie)	Ingram, Eleanor M
Somerville, E. Œ. (Edith Œnone)	Somerville, E. Œ. (Edith Œnone)	Somerville, E. Œ (Edith Œnone)
Sothern, E. H. (Edward Hugh)	Sothern, E. H	Sothern, E. H. (Edward Hugh)
Soulié de Morant, G. (Georges)	Soulié de Morant, G. (Georges)	Soulié de Morant, G (Georges)
Southworth, S. A, Mrs	Southworth, S. A, Mrs	Southworth, S. A
Garshin, V. M. (Vsevolod Mikhaĭlovich)	Garshin, V. M. (Vsevolod Mikhaĭlovich)	Garshin, V. M (Vsevolod Mikhaı̆lovich)	Garshin, V. M. (Vsevolod Mikhaĭlovich)
Gaskell, Catherine Henrietta Milnes, Lady	Gaskell, Catherine Henrietta Milnes, Lady	Gaskell, Catherine Henrietta Milnes
Gaunt, Mary (Mary Eliza Bakewell)	Gaunt, Mary Eliza Bakewell	Gaunt, Mary (Mary Eliza Bakewell)
Gabriel, Gilbert W. (Gilbert Wolf)	Gabriel, Gilbert W. (Gilbert Wolf)	Gabriel, Gilbert W
Gardener, Helen H. (Helen Hamilton)	Gardener, Helen H	Gardener, Helen H. (Helen Hamilton)
Gatty, Alfred, Mrs	Gatty, Alfred	Gatty, Alfred, Mrs
Garstin, Denis (Denis Norman)	Garstin, Denis (Denis Norman)	Garstin, Denis Norman
Gaines, Nettie S. (Nettie Stewart)	Gaines, Nettie S. (Nettie Stewart)	Gaines, Nettie S
Salinger, J. D. (Jerome David)	Salinger, J. D. (Jerome David)	Salinger, J. D (Jerome David)
Sackville-West, V. (Victoria)	Sackville-West, V (Victoria)	Sackville-West, V	Sackville-West, V. (Victoria)
Sargent, Lucius M. (Lucius Manlius)	Sargent, Lucius M. (Lucius Manlius)	Sargent, Lucius M
Sarma, D. S. (Dittakavi Subrahmanya)	Sarma, D. S (Dittakavi Subrahmanya)	Sarma, D. S. (Dittakavi Subrahmanya)
Sawhney, S. P.	Sawhney, S P	Sawhney, S. P
Sabin, Edwin L. (Edwin Legrand)	Sabin, Edwin L. (Edwin Legrand)	Sabin, Edwin L
Sanders, Charles W. (Charles Walton)	Sanders, Charles W	Sanders, Charles W. (Charles Walton)
Sanchez, Nellie (Van de Grift), Mrs	Sanchez, Nellie Van de Grift	Sanchez, Nellie (Van de Grift), Mrs
Sawyer, Josephine Caroline	Sawyer, Josephine Caroline	Sawyer, Josephine Carolyn
Salisbury, Harrison E. (Harrison Evans)	Salisbury, Harrison E (Harrison Evans)	Salisbury, Harrison E. (Harrison Evans)
Sawyer, Caroline M. (Caroline Mehetabel)	Sawyer, Caroline M. (Caroline Mehetabel)	Sawyer, Caroline M
Sangster, Margaret E. (Margaret Elizabeth)	Sangster, Margaret E. (Margaret Elizabeth)	Sangster, Margaret E
Sampson, Mrs. Emma (Speed)	Sampson, Mrs. Emma (Speed)	Sampson, Emma Speed
Savinkov, B. V. (Boris Viktorovich)	Savinkov, B. V. (Boris Viktorovich)	Savinkov, B. V
Saint, More, Thomas, Sir	Saint, More, Thomas, Sir	Saint, More, Thomas
Sadhu, S. L. (Shyam Lal)	Sadhu, S. L (Shyam Lal)	Sadhu, S. L. (Shyam Lal)
Samuels, Edward A. (Edward Augustus)	Samuels, Edward A	Samuels, Edward A. (Edward Augustus)
Sandys, Edwyn	Sandys, Edwyn. [from old catalog]	Sandys, Edwyn
Safroni-Middleton, A (Arnold)	Safroni-Middleton, A	Safroni-Middleton, A (Arnold)
Sayers, Dorothy L. (Dorothy Leigh)	Sayers, Dorothy L (Dorothy Leigh)	Sayers, Dorothy L. (Dorothy Leigh)
Ebbutt, M. I. (Maud Isabel)	Ebbutt, M. I	Ebbutt, M. I. (Maud Isabel)
Eberhart, Mignon (Good), Mrs	Eberhart, Mignon (Good), Mrs	Eberhart, Mignon Good
Diaz, Mrs. Abby Morton	Diaz, Abby Morton	Diaz, Mrs. Abby Morton
Dimock, A. W. (Anthony Weston)	Dimock, A. W. (Anthony Weston)	Dimock, A. W
Dillon, Mary (Mary C. Johnson)	Dillon, Mary C. Johnson, Mrs	Dillon, Mary (Mary C. Johnson)	Dillon, Mary C. Johnson	Dillon, Mary C. (Johnson)
Dillon, Henry Augustus Dillon-Lee	Dillon, Henry Augustus Dillon-Lee	Dillon, Henry Augustus
Divine, A. D. (Arthur Durham)	Divine, A. D (Arthur Durham)	Divine, A. D. (Arthur Durham)
Dilke, Charles Wentworth, Sir	Dilke, Charles Wentworth, Sir	Dilke, Charles Wentworth
Dickinson, Anna E. (Anna Elizabeth)	Dickinson, Anna E	Dickinson, Anna E. (Anna Elizabeth)
Dixon, Pierson, Sir	Dixon, Pierson, Sir	Dixon, Pierson
Shane, Peggy (Smith)], Mrs	[Shane, Peggy (Smith)]	[Shane, Peggy (Smith)], Mrs
Thurston, E. Temple (Ernest Temple)	Thurston, E. Temple	Thurston, E. Temple (Ernest Temple)
Thruston, Lucy Meacham (Kidd), Mrs	Thruston, Lucy Meacham (Kidd)	Thruston, Lucy Meacham (Kidd), Mrs	Thruston, Lucy Meacham Kidd	Thruston, Lucy Meacham Kidd, Mrs
Thirkell, Angela (Mackail)	Thirkell, Angela Mackail	Thirkell, Angela (Mackail)
Thompson, Daniel P. (Daniel Pierce)	Thompson, Daniel P. (Daniel Pierce)	Thompson, Daniel P
Theiss, Lewis E. (Lewis Edwin)	Theiss, Lewis E. (Lewis Edwin)	Theiss, Lewis E
Knipe, Emilie (Benson), Mrs	Knipe, Emilie (Benson), Mrs	Knipe, Emilie Benson
Trowbridge, W. R. H. (William Rutherford Hayes)	Trowbridge, W. R. H. (William Rutherford Hayes)	Trowbridge, W. R. H
Trevelyan, L. R, Mrs	Trevelyan, L. R	Trevelyan, L. R, Mrs
Trevelyan, George Otto, Sir	Trevelyan, George Otto, Sir	Trevelyan, George Otto
Trowbridge, J. T. (John Townsend)	Trowbridge, J. T. (John Townsend)	Trowbridge, J. T
